Input 	 Actual Predicted 
ank	अंक	एनान
anka	अंक	अनना
ankit	अंकित	एनेंस
anakon	अंकों	अनाकों
ankhon	अंकों	अंकों
ankon	अंकों	एनानों
angkor	अंकोर	अंगूक
ankor	अंकोर	अंकूर
angaarak	अंगारक	अंगपाकार
angarak	अंगारक	अंगपाकार
angraji	अंग्रज़ी	अंगराजी
angreji	अंग्रज़ी	अंजीरी
angrzi	अंग्रज़ी	अंजीपुर
antah	अंतः	अंताह
antaha	अंतः	अंताह
antarmukh	अंतर्मुख	अंतर्वित
antmurkh	अंतर्मुख	अंतरोचित
antrmukh	अंतर्मुख	अंतर्मिक
andrabee	अंद्राबी	अंदरारे
andrabi	अंद्राबी	अंदरी
andha	अंधा	अंधा
andhapan	अंधापन	अंधका
andheri	अंधेरी	अंधरी
ambaani	अंबानी	अमीनाए
ambani	अंबानी	अमीका
akram	अकरम	अकार्म
acapulco	अकापुल्को	अक्प्रोसियों
akapulko	अकापुल्को	अकारपुत्रों
akhand	अखंड	अखंड
akhil	अखिल	अखील
agavai	अगवाई	अगावी
agvaai	अगवाई	अगवायी
augustine	अगस्टाइन	ऑस्यूमिक
augustustine	अगस्टाइन	ऑस्ट्रोस्क्रिपियों
agsta	अगस्ता	असमान
agusta	अगस्ता	अजुला
augusta	अगस्ता	ऑसबास
agr	अग्र	एजरी
agra	अग्र	अगरा
achambha	अचंभा	अछमाह
achanbha	अचंभा	अछाना
achievement	अचीवमेंट	अक्लिवर्शन
achivement	अचीवमेंट	अक्लियोधर्मी
acchi	अच्छी	एची
achchi	अच्छी	अछिए
achhi	अच्छी	अछिए
achyut	अच्युत	एचुस
achhanera	अछनेरा	अच्छापाव
achnera	अछनेरा	अचापेय
ajmeedh	अजमीढ़	अज्ञेतिह
ajhar	अजहर	अजहर
azhar	अजहर	अजरह
ajit	अजित	एस्टे
agnat	अज्ञात	अजना
agyaat	अज्ञात	अग्यता
agyat	अज्ञात	अग्यता
atakta	अटकता	अतकात
atkata	अटकता	अतकात
atake	अटके	अतकाई
atke	अटके	एटी
atwaal	अटवाल	अत्वल
atwal	अटवाल	अत्वल
attahasa	अट्टहास	अत्थाया
atthaas	अट्टहास	अताश्त
atthas	अट्टहास	अताश
addon	अड्डों	एडोडिंग
athak	अथक	अथक
atharv	अथर्व	अथारह
atharva	अथर्व	अथारहा
adad	अदद	अद्द
adaani	अदाणी	अदाइन
adani	अदाणी	एडनी
advait	अद्वैत	अद्दालिया
adwait	अद्वैत	अद्धात्व
advaitvaad	अद्वैतवाद	अद्धाविता
advaitwad	अद्वैतवाद	अद्धाविता
adhivas	अधिवास	अधिवास
adhiwas	अधिवास	अधिवास
advivas	अधिवास	अदिवासी
adhiik	अधीक	अधिकी
adhik	अधीक	अधिक
adhyayanarat	अध्ययनरत	अध्यापत्र
adhyayanrat	अध्ययनरत	अध्यापत्र
adhyaynrat	अध्ययनरत	अध्यापत्र
anant	अनंत	अंकात
ananti	अनंती	अंकाल
angadh	अनगढ़	अंगाह
angarh	अनगढ़	अंगार्व
anchahe	अनचाहे	अनेहाड़
anthak	अनथक	अंठन
unthak	अनथक	उन्हतां
anhoni	अनहोनी	अनुहों
anaavashyak	अनावश्यक	अंधकाश्यन
anavashyak	अनावश्यक	अंधायास्यापूर्ण
anavshyak	अनावश्यक	अंधसानिक
anawashyak	अनावश्यक	अंधायास्यापूर्ण
anik	अनिक	एनिक
anishwarvadi	अनीश्वरवादी	अंध्यविवासी
anishwarwadi	अनीश्वरवादी	अंध्यविवासी
anukoltha	अनुकूलता	अनुभात्मि
anukulata	अनुकूलता	अनुमानिता
anukulta	अनुकूलता	अनुकासिताएं
anuchit	अनुचित	अनुभूत
anuprayogi	अनुप्रयोगों	अनुपरियों
anuprayogon	अनुप्रयोगों	अनुपयोगिक
anupryogon	अनुप्रयोगों	अनुपूर्ण
anureet	अनुरीत	अनुपर्ती
anurit	अनुरीत	अनुपूर्त
anuthi	अनूठी	अंचूत
anudit	अनूदित	अनुष्क
anyaay	अन्याय	अन्याया
anyay	अन्याय	अन्या
anyaya	अन्याय	अन्याया
apnani	अपनानी	अपनाइ
aparivartanshali	अपरिवर्तनशील	अपरिवांशित्वतार
aparivartansheel	अपरिवर्तनशील	अपरिवांचल्चताथ
aparivartanshil	अपरिवर्तनशील	अपरिवांशित्रता
apariharya	अपरिहार्य	अपराविया
aprihary	अपरिहार्य	अपरिवार
apriyary	अपरिहार्य	अपरियार
apavartit	अपवर्तित	अपालक्षर
apvartit	अपवर्तित	अपत्रेश्र
apvtrit	अपवर्तित	अप्टर्डिक्स
apaardarshi	अपारदर्शी	अपहर्श्वर
apardarshi	अपारदर्शी	अपराधिकार
afroj	अफरोज	अफोर्स
afroz	अफरोज	अफोर्स
africa	अफ्रीका	अत्रिया
abbaasi	अब्बासी	अबाली
abbasi	अब्बासी	अबियाल
abhimat	अभिमत	अभिष्म
abhishap	अभिशाप	अभिष्प्र
abhi	अभी	एबी
amjhera	अमझेरा	अम्मर्च
amzera	अमझेरा	अम्रता
amargad	अमरगढ़	अमराद
amargarh	अमरगढ़	अमराव
amarpaal	अमरपाल	अमरात्री
amarpal	अमरपाल	अमराती
amarohi	अमरोही	अमरोवी
amrohi	अमरोही	अमोरी
amaanat	अमानत	अमानता
amanat	अमानत	अमानता
amanth	अमानत	अमांठ
amaanati	अमानती	अमानाल
amanathi	अमानती	अमानेश
amanati	अमानती	अमानित
amavasya	अमावस्या	अमावसाय
amavsya	अमावस्या	अमामवा
amit	अमित	एमिस
amitao	अमिताव	अमोजिया
amitav	अमिताव	अम्युत्व
amuk	अमुक	अमून
amogh	अमोघ	अमोदी
ambani	अम्बानी	अमीका
ayodhyaanaath	अयोध्यानाथ	अयोध्यात्म
ayodhyanaath	अयोध्यानाथ	अयोध्यात्मक
ayodhyanath	अयोध्यानाथ	अयोध्यात्मक
ayodhyeanath	अयोध्यानाथ	अयोधन्यता
aradas	अरदास	आर्वत
ardaas	अरदास	आर्दासा
ardas	अरदास	आर्दाज
arabab	अरबाब	अरबारे
arbab	अरबाब	अरबार
around	अराउंड	आरोहों
arjent	अर्जेंट	आर्जेंट
urgent	अर्जेंट	उर्मिक
arth	अर्थ	आर्थ
artha	अर्थ	अर्था
earth	अर्थ	एर्ड्स
earthquake	अर्थक्वेक	एर्डेक्ट्रेंस
arthon	अर्थों	आर्डों
arpit	अर्पित	अर्पेंस
aryama	अर्यमा	आयरम
aryma	अर्यमा	आर्गास
arymaa	अर्यमा	आर्गास
alankaar	अलंकार	अलंकार
alankar	अलंकार	अलंकर
alnkaar	अलंकार	अलंकर
alankaaron	अलंकारों	अलंकारों
alankaron	अलंकारों	अलंकारों
alnkaaron	अलंकारों	अलंकारों
alnkaron	अलंकारों	अलंकरण
alagavavadi	अलगाववादी	अलगवादीय
algavvadi	अलगाववादी	अब्मावविद्य
algavwaadi	अलगाववादी	अब्मावविद्य
alive	अलाइव	एलिव
alance	अलायंस	अलंके
alayans	अलायंस	अलायनास
aliance	अलायंस	एलिने
alind	अलिंद	एलिंग
alai	अली	एलिया
ali	अली	एलिए
alii	अली	एलिय
alonso	अलोंसो	एलोम
aloso	अलोंसो	एलोस
alphabet	अल्फ़ाबेट	अल्फेंडर
alba	अल्बा	अलबा
avantipur	अवंतिपुर	अवनिक्षण
awantipora	अवंतिपुर	अवनाक्षीय
avaru	अवरु	आवरी
avru	अवरु	आवरी
awaru	अवरु	आवरी
avarodhak	अवरोधक	अवर्धकों
avrodhak	अवरोधक	अवरुद्धन
avrodhk	अवरोधक	आवृद्ध
avarnata	अवर्णता	अवरंता
avarnataa	अवर्णता	अवरंता
avranta	अवर्णता	अवरंत
avashist	अवशिष्ट	अवशेषत
avshisht	अवशिष्ट	अवश्युत्त
awashist	अवशिष्ट	अवशेषत
avasthaayen	अवस्थाएं	अवश्यनाथ
avsthaen	अवस्थाएं	अवस्थानी
avsthayen	अवस्थाएं	अवस्थानी
awasthaen	अवस्थाएं	अवश्यनाथ
avi	अवि	एविए
avika	अविका	अविका
aviral	अविरल	अविरल
avirl	अविरल	अविजी
avishvaasniy	अविश्वसनीय	अविष्यावस्थ
avishvasniy	अविश्वसनीय	अविष्यावस्थ
avishvasniya	अविश्वसनीय	अविष्यावादिता
avisvasniya	अविश्वसनीय	अविष्यावतों
aviva	अवीवा	अववाद
avaigyanic	अवैज्ञानिक	अवैंगियां
avaigyanik	अवैज्ञानिक	अवैंगिकाओं
avegyanik	अवैज्ञानिक	अविगानिका
ashaktataa	अशक्तता	असहात्कता
ashktta	अशक्तता	अस्थाकत
asharaphi	अशरफी	अश्वर्भ
ashrafi	अशरफी	अस्वीतर
ashariri	अशरीरी	अश्विरी
ashriri	अशरीरी	अश्रिय
ashrvatath	अश्वत्थ	अश्वत्थि
ashvtth	अश्वत्थ	अश्वत्त
asamaany	असमान्य	असामान्य
asamany	असमान्य	असामान्य
asmanye	असमान्य	असंबाग
asaamnjsy	असामंजस्य	असमास्त
asamanjasy	असामंजस्य	असमासता
asamanjasya	असामंजस्य	असमासता
asurakshit	असुरक्षित	अस्थिरिक्स
asurkshit	असुरक्षित	अस्त्रिक्स
aset	असेट	एस्ट
asset	असेट	एस्टेस
asvabhavik	अस्वभाविक	अस्वाबधियां
aswabhavik	अस्वभाविक	अस्वाबधियां
aswbhavik	अस्वभाविक	असभ्विद्धि
ahirauli	अहिरौली	अहरलूरी
item	आइटम	इत्स
items	आइटम्स	इत्सम
idle	आइडल	इडल
idol	आइडल	इडोल
icc	आइसीसी	आईआईएस
iso	आइसो	आईसीए
ipc	आईपीसी	आईपी
ipad	आईपैड	इंह
iris	आईरिस	आइरिस
ounce	आउंस	ओएनएसएस
aakaash	आकाश	आकाश
aakash	आकाश	आक्षा
aake	आके	आके
aakhet	आखेट	आख्ते
akhet	आखेट	अखीत
aagat	आगत	आजन
aagaman	आगमन	आगामय
aagman	आगमन	आज्ञान
aagaa	आग़ा	आगा
aagah	आग़ा	आगाह
agha	आग़ा	अगाह
aagaashe	आगाशे	आगाहल
aagashe	आगाशे	आगाहेल
agashe	आगाशे	अगाहेज
aajmaanaa	आजमाना	आजमाना
aajmana	आजमाना	आजमाना
aazmaanaa	आजमाना	आजमाना
aata	आटा	आता
ata	आटा	अता
atta	आटा	अताता
aatmayen	आत्माएं	आत्मणि
atmaen	आत्माएं	अत्मान
aadaan	आदान	आदान
aadan	आदान	आदान
aadhaarit	आधारित	आधार्थ
aadharit	आधारित	आधर्ति
adharit	आधारित	अध्यक्रम
aadheen	आधीन	आधिन
aadhin	आधीन	आधिन
aadhunik	आधुनिक	आधूनकों
aanad	आनद	आंका
aanand	आनद	आंका
anand	आनद	अंका
aapka	आपका	आपान
aapkaa	आपका	आपाना
aapadaaaen	आपदाएं	आपाड़का
aapdaein	आपदाएं	आपदिकार
aapdayein	आपदाएं	आपदियार
aabantit	आबंटित	आलंकेत
abantit	आबंटित	अबनाती
aabru	आबरू	आबूर
abaru	आबरू	अबरो
aamdan	आमदन	आमदान
amadan	आमदन	अमानद
aamdani	आमदनी	आमदानी
amadani	आमदनी	अमान्नाच
aamdi	आमदी	आमदी
amdi	आमदी	अम्ने
aamod	आमोद	आमों
amod	आमोद	आमों
aayenge	आयेंगे	आयेगे
aayojak	आयोजक	आयोजक
ro	आरओ	आउल
rp	आरपी	आप
aaraam	आराम	आराम
aaram	आराम	आर्म
aram	आराम	आर्म
aarushi	आरुषि	आर्शीय
arushi	आरुषि	आर्चिल
artery	आर्टरी	अर्फ्रे
order	आर्डर	ओर्डे
aary	आर्य	आर्य
aarya	आर्य	आरय
arya	आर्य	आर्या
aaryika	आर्यिका	आर्याकार
aryika	आर्यिका	आर्याकार
aarya	आर्यो	आरय
arya	आर्यो	आर्या
aryo	आर्यो	आरो
aaryan	आर्यों	आर्याप्प
arya	आर्यों	आर्या
aryon	आर्यों	आरोप
aalsi	आलसी	आलसी
alasi	आलसी	अलासी
aalochak	आलोचक	आलुक्षण
alochak	आलोचक	अलुका
aalochakon	आलोचकों	आलुक्षण
alochakon	आलोचकों	अलुकांड
aalha	आल्हा	आला
aalhaa	आल्हा	आला
alha	आल्हा	अलाह
allah	आल्हा	अल्लाह
aawaazen	आवाज़ें	आवाजिक
aawajen	आवाज़ें	आवाजिक
awaazen	आवाज़ें	अवाजानी
awazen	आवाज़ें	अवजें
aawajon	आवाज़ों	आवासों
aawazon	आवाज़ों	आवासों
awaazon	आवाज़ों	अवाजन
awazon	आवाज़ों	आवाजों
aavishakaar	आविष्कार	आविष्क्र
aavishkaar	आविष्कार	आविष्क्र
avishkar	आविष्कार	अविष्कार
aavriti	आवृत्ति	आवर्ती
aavritti	आवृत्ति	आवृत्ति
avuti	आवृत्ति	अवूजी
aavritiyon	आवृत्तियों	आवृतियों
aavrittiyon	आवृत्तियों	आवृतियों
avrutiyon	आवृत्तियों	अवर्तियों
aashanka	आशंका	आशान्यक
ashanka	आशंका	असहनाक
aashriton	आश्रितों	आश्रितों
ashriton	आश्रितों	अश्रितों
aasaan	आसान	आसान
aasan	आसान	आसान
asan	आसान	असांग
aastik	आस्तिक	आस्तेक
astik	आस्तिक	एस्टेक
aasteen	आस्तीन	आस्तेनी
aastin	आस्तीन	आसिंत
astin	आस्तीन	एसिंस
aahnaan	आह्नान	आहना
aahnan	आह्नान	आहना
ahyan	आह्नान	आहयन
england	इंग्लैंड	एंगडित
engineer	इंजिनियर	एकग्रीन
introduction	इंट्रोडक्शन	इंतरोहितों
insurance	इंश्योरेंस	इंसर्की
ear	इअर	एर्न
eyer	इअर	एयर
eon	इआन	एचों
iaan	इआन	आईआईएब
ekattha	इकट्ठा	एकताश
ikattha	इकट्ठा	इक्तात्व
ekatthi	इकठ्ठी	एकत्ती
ekthi	इकठ्ठी	एकाहित
ikatthi	इकठ्ठी	इक्कठेस
ekaee	इकाई	एकाई
ikai	इकाई	इकी
ekaeyon	इकाईयों	एकायिक
ikaiyon	इकाईयों	इक्कायी
ikarion	इकाईयों	इक्करियों
economic	इकोनोमिक	एकॉनिसन
ecuador	इक्वाडोर	एकोवर्ड
equador	इक्वाडोर	एकोद्रीय
equities	इक्विटीज	एकोलिक्स
ikvitija	इक्विटीज	इक्कालित्व
ijaajat	इजाजत	आयाज़ते
ijajat	इजाजत	आयज्ताम
inhalation	इनहेलेशन	इंहलिक्स
inhaletion	इनहेलेशन	इंचितियों
ibija	इबीजा	इब्बमी
ibiza	इबीजा	इब्बमी
imaging	इमेजिंग	इमानी
immune	इम्युन	इम्बूट
elaichi	इलाइची	एलिवेड
ilaichi	इलाइची	इल्हिए
ilayachi	इलाइची	इलायदी
ilayichi	इलाइची	इल्हियां
elaaj	इलाज	एलाज
ilaaj	इलाज	इल्सा
ilaj	इलाज	इल्स
ishaak	इशाक	इशाक
ishaaq	इशाक	इशाक
ishak	इशाक	इश्क
ishaara	इशारा	इशारा
ishaaraa	इशारा	इशारा
ishara	इशारा	इशारा
ishita	इशिता	इश्कल
isht	इष्ट	इस्थ
isteefe	इस्तीफे	इस्तेले
istife	इस्तीफे	इस्तेस
ea	ईए	एता
ia	ईए	आईआई
eater	ईटर	एतर
iter	ईटर	इतर
email	ईमेल	एमिल
emailon	ईमेलों	एमियाइट
emelon	ईमेलों	एमिसन
evening	ईवनिंग	एविन
east	ईष्ट	एस्ट
ishat	ईष्ट	इश्ता
isht	ईष्ट	इस्थ
isaaiyon	ईसाइयों	इसायिक
isaiyon	ईसाइयों	इसाइयों
isayiyon	ईसाइयों	इसायिक
ikhrul	उखरुल	इक्षरी
ukhrool	उखरुल	उखरील
ukhrul	उखरुल	उखरील
uchhalane	उछालने	उछलने
uchhalne	उछालने	उछालने
ujback	उज़्बेक	उजानें
uzbek	उज़्बेक	उज्कें
uthane	उठने	उठाने
uthne	उठने	उठने
uthaakar	उठाकर	उठाकर
uthakar	उठाकर	उठाकर
uthaapatak	उठापटक	उठातापन
uthapatak	उठापटक	उठापतान
uthen	उठें	उठाने
udaan	उड़ान	उदाना
udan	उड़ान	उदन
udaanaa	उड़ाना	उदाना
udana	उड़ाना	उदाना
udaane	उड़ाने	उदाने
udane	उड़ाने	उदने
udaanen	उड़ानें	उदानें
udanen	उड़ानें	उदनें
udaanon	उड़ानों	उदानों
udanon	उड़ानों	उदानों
utane	उतने	उताने
utaney	उतने	उताने
utne	उतने	उतने
uttara	उत्तरा	उतत्यार
uttra	उत्तरा	उत्त्र
utpan	उत्पन	उत्पान
udant	उदंत	उदंत
udghosh	उदघोष	उद्गमी
udar	उदर	उदार
uda	उदा	उदा
udaa	उदा	उदा
udakishuganj	उदाकिशुनगंज	उदाकिष्ठिक
udakishunganj	उदाकिशुनगंज	उद्देशिताओं
unatees	उनतीस	उनतेम
untees	उनतीस	अनटेस
uniyal	उनियाल	उन्बल
upadraviyon	उपद्रवियों	उपद्ञाखीयों
updravion	उपद्रवियों	उपद्गार्डियों
updraviyon	उपद्रवियों	उपद्गार्चि
upadravi	उपद्रवी	उपद्धारी
updravi	उपद्रवी	उपद्गरी
upadrawon	उपद्रवों	उपद्ञाखोर
updravon	उपद्रवों	उपद्गार्डिंग
upneta	उपनेता	उपनते
upabhokta	उपभोक्ता	उपनंदर्कल
upbhokta	उपभोक्ता	उपचार्कता
uplaksh	उपलक्ष्य	उपल्पत्र
uplakshay	उपलक्ष्य	उपलेंद्स
uplakshya	उपलक्ष्य	उपलांश
uplabdh	उपलब्ध	उपवेदे
uplabdhiyon	उपलब्धियों	उपविदेशों
uplabdhi	उपलब्धी	उपवेंदल
upakhyaanon	उपाख्यानों	उपकायों
upakhyanon	उपाख्यानों	उपकायों
ubuntu	उबंटू	उबुते
ubaal	उबाल	उबला
ubal	उबाल	उबल
ubhaara	उभारा	उभापर
ubhara	उभारा	उभरण
umanath	उमानाथ	उम्मदाद
umesh	उमेश	उम्मेद
urf	उर्फ	आर्स
urfa	उर्फ	उर्ता
urff	उर्फ	आर्ट्स
urvarakon	उर्वरकों	उर्वार्कों
urvarkon	उर्वरकों	उर्वारों
urwarakon	उर्वरकों	उर्वार्कों
urvarata	उर्वरता	उर्वार्था
urvarta	उर्वरता	उर्वार्था
urwarta	उर्वरता	उर्वार्था
ulate	उलटे	उल्ला
ulte	उलटे	उत्ते
ulahana	उलाहना	उलांदाब
ulahna	उलाहना	उलांदा
ulema	उलेमा	उल्मा
ulemaon	उलेमाओं	उल्लाओं
usak	उसक	उजाक
usaki	उसकी	उजाइक
uski	उसकी	उज़ी
usmein	उसमें	उस्मीन
usmen	उसमें	उस्मीन
usi	उसी	उसू
ustara	उस्तरा	उस्तरा
udharv	ऊर्ध्व	उदारहव
udhrva	ऊर्ध्व	उद्धरी
urdhav	ऊर्ध्व	उर्द्वा
ushma	ऊष्मा	उष्मा
rishicool	ऋषिकुल	रुशिसियों
rishikul	ऋषिकुल	रुशिलिक
rushikul	ऋषिकुल	रुशुक्षी
enzyme	एंजाइम	एंगल
anton	एंटोन	एंटोंस
entone	एंटोन	एनतून
antoni	एंटोनी	एंबोन
antony	एंटोनी	एंस्कों
endometrial	एंडोमेट्रियल	एंडोप्सेशिक्स
andreas	एंड्रियास	अंदर्स
als	एएलएस	एसिस
asi	एएसआई	एसी
eksaath	एकसाथ	एकस्थ
eksath	एकसाथ	एकस्थ
ekaki	एकाकी	एकाकी
xm	एक्सएम	एमप्स
egmor	एगमोर	एमोर
egmore	एगमोर	एमरू
aj	एजे	एज
agende	एजेंडे	एजेंच
adp	एडीपी	एडपी
adain	एडेन	एडीन
aden	एडेन	एडेन
edan	एडेन	एडान
addi	एड्डी	एडी
eddi	एड्डी	एडिड
eddie	एड्डी	एडिड
eddy	एड्डी	एडडो
apj	एपीजे	एन्स
ftii	एफटीआईआई	फ़ील
abbott	एबट	एब्सेंस
abut	एबट	एबूट
ebt	एबट	एनते
abvp	एबीवीपी	एबवा
abbot	एबोट	एबूट
abbott	एबोट	एब्सेंस
mta	एमटीए	मैत
mtake	एमटेक	मैक्केस
mtec	एमटेक	मैक्स
mtech	एमटेक	मेड्स
emerald	एमरल्ड	एमरेश
emrald	एमरल्ड	एमरोथ
emil	एमिल	एमिस
emile	एमिल	एमिल
emily	एमिल	एमिल
amy	एमी	अम्य
emi	एमी	एमिय
airway	एयरवे	एयरवाई
eyarave	एयरवे	एयरवी
eyarve	एयरवे	एयरवी
error	एरर	एरिय
arica	एरिका	आरिया
erica	एरिका	एरिका
erika	एरिका	एरिका
aerobic	एरोबिक	एयरबून
aerobics	एरोबिक	एयरबूलों
lte	एलटीई	एला
lti	एलटीई	ल्फी
allergic	एलर्जिक	एलिस्प्रेक्ट
eliminator	एलिमिनेटर	एल्स्क्रिंग
aliens	एलियंस	एलिंग
alliance	एलियंस	एलिलानिक
asian	एशियन	एसिंग
sfc	एसएफसी	स्ट
sk	एसके	स्क
spf	एसपीएफ	स्प्ट
association	एसोसिएशन	असिस्तिकों
astar	एस्टर	अस्त्र
aster	एस्टर	अस्त्री
ester	एस्टर	एस्टर
aesthetics	एस्थेटिक	एस्टेशिक्स
asthetic	एस्थेटिक	अस्थितिक
asfalt	एस्फाल्ट	असलता
asphalt	एस्फाल्ट	अस्पाश्रम
asphault	एस्फाल्ट	अस्पभूति
ahsaas	एहसास	आशास
ehsaas	एहसास	एहस्स
ehsas	एहसास	एहस्स
aisa	एेसा	एसिया
eesa	एेसा	एल्सा
ainth	ऐंठ	एंच
end	ऐंठ	एंड
enth	ऐंठ	एनडीएम
ainthey	ऐंठे	एंडीबाल
enthe	ऐंठे	एनडीएस
aithan	ऐठन	ऐलानद
ethan	ऐठन	एताने
ethhan	ऐठन	एकाधें
ail	ऐल	एल्स
el	ऐल	एल
alaps	ऐल्प्स	अल्प्स
alps	ऐल्प्स	एल्स
aise	ऐसे	एसे
oxide	ऑक्साइड	ओडिस
oxy	ऑक्सी	ओएस
offers	ऑफर्स	ओरफ्ट
offshor	ऑफशोर	ओवर्त
offshore	ऑफशोर	ओवर्तेस
official	ऑफिशियल	ऑफल्सियाई
okalahoma	ओकलाहोमा	ओकलाशय
oklahoma	ओकलाहोमा	ओकलाश
oklahoma	ओक्लाहोमा	ओकलाश
ot	ओत	ओएसए
opel	ओपेल	ओप्ल
obrayan	ओब्रायन	ओपार्का
obrien	ओब्रायन	ओपिकी
oran	ओरण	ओरान
orian	ओरियन	ओर्काइंग
orion	ओरियन	ओरोकोर
olavrishti	ओलावृष्टि	ओवर्शिस्टर
ovum	ओवम	ओवीम
owem	ओवम	ओवेम
oceanic	ओशनिक	ओकाइनिंग
osaka	ओसाका	ओजाका
auchity	औचित्य	ऑचुसिया
auchitya	औचित्य	ऑकुलिया
audhyogikaran	औद्योगिकरण	औधारियों
audyogikarana	औद्योगिकरण	ऑक्यूनियां
audyogikikaran	औद्योगिकरण	ऑक्यूरियों
aurangabad	औरंगाबाद	आयुर्णवा
aurora	औरोरा	आयूरी
aulakh	औलख	ऑलुड
kankad	कंकड़	कंका
kankar	कंकड़	कंकार
kankad	कंकर	कंका
kankar	कंकर	कंकार
kangan	कंगन	कंगान
conjunction	कंजंक्शन	कंट्यूनिक्स
contemporary	कंटेम्पररी	कंसर्कल
kanthahar	कंठहार	कंधराज
kanthhar	कंठहार	कंधर
composer	कंपोजर	कम्यूर्स
kambalon	कंबलों	कामितिया
kanblon	कंबलों	कनिती
consultant	कंसलटेंट	कंसेस्ट्रक्ट
kakkad	कक्कड़	ककड़
kakkar	कक्कड़	ककार
kacche	कच्चे	कचे
kachche	कच्चे	कच्छे
karta	कटरा	कर्ता
katra	कटरा	कतरा
cutlery	कटलरी	कल्टरी
katlari	कटलरी	कत्त्रीय
katlary	कटलरी	कत्त्रिया
katasaraj	कटासराज	कत्यामर
kathfodave	कठफोड़वे	कथार्थो
kathfodve	कठफोड़वे	कथार्थ
kathor	कठोर	कथोर
kathore	कठोर	कथरी
kanika	कणिका	कनिका
kathai	कत्थई	काथि
katthai	कत्थई	कट्ठाब
katthaii	कत्थई	कतलही
convention	कनवेंशन	कंड्रिक्स
canals	कनाल	कैनल
kanaal	कनाल	कनाल
kanal	कनाल	कनाल
kanindham	कनिंघम	कनीदाती
kaningham	कनिंघम	कनिष्य
kanishthika	कनिष्ठिका	कंशिकालिक
kanishthikaa	कनिष्ठिका	कंशिकालिक
kanishtika	कनिष्ठिका	कनीश्तानी
kanyaayen	कन्याएं	कन्यायाने
kanyaein	कन्याएं	कन्याकारी
kanyayen	कन्याएं	कन्याकार
convention	कन्वेंशन	कंड्रिक्स
convocation	कन्वोकेशन	कोंसर्डिंग्रों
cup	कप	क्प्प
kap	कप	कप
kapda	कपड़ा	कपड़ा
kpada	कपड़ा	कपाड़
kapdo	कपड़ो	कपदो
kapdon	कपड़ो	कपदों
kaping	कपिंग	कपिंग
kping	कपिंग	केपीओरी
kapolkalpana	कपोलकल्पना	कप्रस्कृत
kabaddi	कबड्डी	कबाड़ी
kabr	कब्र	कार्न
kabra	कब्र	काबर
kabren	कब्रें	कांपी
kabron	कब्रों	कांपुर
kamjor	कमज़ोर	कम्रम
kamzor	कमज़ोर	कम्रम
kamatar	कमतर	कमातार
kamtar	कमतर	कमत्र
kalamjeet	कमलजीत	कलमती
kamaljeet	कमलजीत	कमलतेज
kamaauu	कमाऊ	कमायू
kamau	कमाऊ	कमाई
kamaate	कमाते	कमाते
kamate	कमाते	कमाते
kamere	कमेरे	कार्बल
kmere	कमेरे	केमर
karanj	करंज	कराम
kranj	करंज	क्रांस
karanjiya	करंजिया	करामानी
kardhe	करघे	कर्देह
karghe	करघे	कर्गेह
karachana	करछना	करहाना
karchhana	करछना	कर्चना
karna	करना	करना
karpatri	करपात्री	कर्णेत्र
karam	करम	करम
karoor	करूर	करोरी
karur	करूर	करूर
karnataka	कर्नाटका	कर्णाप्तक
karvi	कर्वी	करवी
kurvi	कर्वी	कुर्वी
kalmein	कलमें	कैस्टिन
kalmen	कलमें	कैस्टेंस
kalraj	कलराज	कल्रम
kalika	कलिका	कलिका
kalpanaon	कल्पनाओं	कलपों
kalpnaon	कल्पनाओं	कलपों
kavvaliyon	कव्वालियों	कवलवाइयों
qawwaliyon	कव्वालियों	कवलवादीय
kavvali	कव्वाली	कवलीवाद
qawwali	कव्वाली	कवलवादी
kashton	कष्टों	कस्तूद
kasarat	कसरत	कसरत
kasrat	कसरत	कस्तर
kasara	कसारा	कसरा
kasida	कसीदा	कसीदा
kahane	कहने	कहाने
kahne	कहने	कहने
kahlaya	कहलाया	कहलाया
kahaniyon	कहानियों	कहानियों
kile	क़िले	किल
kanji	कांजी	कंगे
cant	कांट	कैंट
kant	कांट	कंट
kanti	कांति	कंती
kakoo	काकू	काको
kaku	काकू	ककू
kaagaj	कागज़	कागाज
kaagaz	कागज़	कागाज
kagaj	कागज़	कगाज
kagaz	कागज़	कगाज
kaaji	काजी	काजी
kaji	काजी	काजी
kazi	काजी	काजी
qazi	काजी	केज़
kajoo	काजू	काजो
kaju	काजू	काजू
kapadi	कापड़ी	कपाड़ी
kapdi	कापड़ी	कपदी
kamraj	कामराज	कमर्ज
kamottejana	कामोत्तेजना	काम्टनात्मक
kamottejna	कामोत्तेजना	कामुकतातता
kailana	कायलाना	कैलना
kaylana	कायलाना	कायामान
carfi	कार्की	कैर्स
karki	कार्की	करकी
kartik	कार्तिक	कर्क्तिक
karyakartaon	कार्यकर्ताओं	कार्यकालक
karykartaaon	कार्यकर्ताओं	कर्कालकारण
karykartaon	कार्यकर्ताओं	कर्कालकार
karyabhar	कार्यभार	कर्यभार
karybhar	कार्यभार	कर्जभाग
karyarat	कार्यरत	कर्जारय
karyrat	कार्यरत	कर्जार
kaalpi	कालपी	कालपी
kalapi	कालपी	कलापी
kalpi	कालपी	कलपी
kalika	कालिका	कलिका
kalighat	कालीघाट	कलिमादी
coldvel	काल्डवेल	कोल्स
kaldvel	काल्डवेल	कल्वेल
kaldwell	काल्डवेल	कल्टवेशी
kaav	काव	काव
kav	काव	कव
kaasht	काश्त	काश्त
kasht	काश्त	कस्ते
kasim	कासिम	कसीम
qasim	कासिम	कसीम
kasimabad	कासिमाबाद	कसीमादा
kiya	किया	किया
kiliyan	किलियन	किलागिया
killat	किल्लत	किलती
killi	किल्ली	किलली
kisaani	किसानी	किसानी
kisani	किसानी	किसानी
kisanon	किसानों	किसानों
keede	कीड़े	कीड़े
kide	कीड़े	किडे
keynote	कीनोट	केजिन
kinote	कीनोट	किनोति
kiratpur	कीरतपुर	किरक्रम
kundal	कुंडल	कुंदल
kundaliya	कुंडलियाँ	कुंदलीय
kundaliyan	कुंडलियाँ	कुंदालयों
kutta	कुत्ता	कुट्टा
kuposhit	कुपोषित	कुंभूत
kumau	कुमाऊ	कुमाई
kumavat	कुमावत	कुमावत
kumawat	कुमावत	कुमावत
kural	कुराल	कुरल
kurmi	कुर्मी	कुरमी
kursiyon	कुर्सियों	कुर्तियों
kush	कुश	कुश
kushaan	कुषाण	कुशान
kushan	कुषाण	कुशान
kusumalataa	कुसुमलता	कुसलमालय
kusumalta	कुसुमलता	कुसलमाल
kusumlata	कुसुमलता	कुसलमाल
koot	कूट	कूट
kut	कूट	कूट
kritika	कृतिका	क्रीक्रित
kpo	केपीओ	कपो
canterbari	कैंटरबरी	कैंकर्स
canterbury	कैंटरबरी	कैंकर्स
candidate	कैंडिडेट	कंदेंदल
katrina	कैटरीना	कतराएं
caitlyn	कैटलिन	कैक्सिस
cateline	कैटलिन	कैटिंग
catlin	कैटलिन	कैटिंग
cadmium	कैडमियम	कैजिंग
catholic	कैथोलिक	कैथुक्स
catholicon	कैथोलिकों	कैथुक्स
kaetholikon	कैथोलिकों	कैडिस्टिक
capacitor	कैपेसिटर	कैप्लिक
carat	कैरेट	कार्ट
cavity	कैविटी	कैविस्क
cavalry	कैवेलरी	कलवर
kaivelari	कैवेलरी	कैवलीरी
complex	कॉम्प्लेक्स	कमर्क्रिंग
kocchi	कोच्चि	कोचिए
kochi	कोच्चि	कोची
corridor	कोरिडोर	कोर्चिक
corolla	कोरोला	कोर्सल
korola	कोरोला	कोर्सा
caolan	कोलन	कैसन
colan	कोलन	कोलन
colon	कोलन	कोलोन
calling	कोलिंग	कैलिंग
koling	कोलिंग	कोलिंग
colorado	कोलोराडो	कोल्ड्रो
kolorado	कोलोराडो	कोल्ड्रो
kaushal	कौशल	कौशल
kaushalata	कौशलता	कौश्तालय
kaushalta	कौशलता	कौशलता
kaushambi	कौशाम्बी	कौशली
cute	क्यूट	क्ली
quete	क्यूट	क्लेक
cube	क्यूब	कूब
cubeck	क्यूबेक	कूब्नेंस
quebec	क्यूबेक	क्वेन
cubes	क्यूब्स	कूबल
krantiyon	क्रांतियों	क्रांसियों
cric	क्रिक	क्रियर
crick	क्रिक	क्रिक
cricket	क्रिकेट	क्रेक्ट्रेंस
cricketer	क्रिकेटर	क्रेक्ट्रेन
cricketing	क्रिकेटिंग	क्रेकिक्सिक
kriyayog	क्रियायोग	क्रियाओं
christian	क्रिश्चयन	क्रिस्क्लेड
kruger	क्रूगर	कृूग
craig	क्रेग	क्रिग
creg	क्रेग	क्री
cradle	क्रैडल	क्राशी
chrom	क्रोम	चर्म
chrome	क्रोम	चर्ज
client	क्लांइट	क्लिंस
clock	क्लाक	क्लूक
clasen	क्लासें	क्लाइट
classen	क्लासें	क्लाइट
classon	क्लासों	क्लास्सों
clay	क्ले	क्लाई
claris	क्लेरिस	क्लायर्स
cleris	क्लेरिस	क्लिर्स
clerys	क्लेरिस	क्लिर्स
quantico	क्वांटिको	क्वांसिंग
queens	क्वींस	क्वेंस
kshitij	क्षितिज	क्षेत्मी
shitij	क्षितिज	शिल्स
kshin	क्षीण	क्षेंग
shin	क्षीण	शिं
kshetron	क्षेत्रों	क्षेत्रों
shetron	क्षेत्रों	शत्रों
khand	खंडा	खंड
khanda	खंडा	खंडा
khachakhach	खचाखच	खाखेदा
khajarana	खजराना	खजाराना
khajraana	खजराना	खज़कर
khajrana	खजराना	खज़कर
khatakati	खटकती	खत्काती
khatakti	खटकती	खत्काती
kihatkati	खटकती	किहाकते
khattapan	खट्टापन	खत्तपान
khat	खत	खत
khani	खनि	खानी
khanik	खनिक	खंगें
khanikarm	खनिकर्म	खानिकास
khanikarma	खनिकर्म	खानिकामार
khanikarmi	खनिकर्म	खानिकासी
khapat	खपत	खपता
khariya	खरिया	खरीय
khalnayak	खलनायक	खलनाएं
khaaskar	ख़ासकर	खासका
khaskar	ख़ासकर	खस्कार
khaastaur	ख़ासतौर	खासलार
khastaur	ख़ासतौर	खस्त्री
khaibar	ख़ैबर	खैंरे
khyber	ख़ैबर	खिरे
khaein	खाएं	खैनी
khaen	खाएं	खाने
khayen	खाएं	खायने
khaate	खाते	खाते
khaatey	खाते	खाते
khate	खाते	खते
khal	खाल	खल
khinchakar	खिंचकर	खींचार
khinchkar	खिंचकर	खींचार
khilana	खिलाना	खिलना
khinchkar	खींचकर	खींचार
khuda	खुदा	खुड़ा
khudai	खुदाई	खुड़ाई
khurapka	खुरपका	खुरंका
khurpaka	खुरपका	खुरंकार
khurasan	खुरासान	खुर्यता
khushiyan	खुशियां	खुशायुओं
khene	खेने	खेने
khaini	खैनी	खैनी
khairati	खैराती	खैरित
khoikhoi	खोईखोई	खोखियों
khoya	खोया	खोया
gangrel	गंगरेल	गंगरी
gangaajal	गंगाजल	गंगलाम
gangajal	गंगाजल	गंगलाम
gandaki	गंडकी	गंदानी
gandki	गंडकी	गंदीन
gandh	गंध	गंद
gandha	गंध	गंधा
gae	गए	गाई
gaye	गए	गाये
gajara	गजरा	गजारा
gajra	गजरा	गजरा
gadkar	गडकर	गड़कर
ganapati	गणपति	गणपती
ganpati	गणपति	गणपती
gatisheel	गतिशील	गतिष्टी
gatishil	गतिशील	गतिष्ली
gatishilata	गतिशीलता	गतिष्लयात्मि
gadadhar	गदाधर	गद्धार
gammat	गम्मत	गम्मता
gaya	गया	गाया
garibi	गरीबी	गरीबी
garjana	गर्जना	गर्जना
galgand	गलगंड	गैयमों
gahmagahmi	गहमागहमी	गहमाशीय
gemhagehmi	गहमागहमी	गिम्मेदावी
ganguly	गांगुली	गंगली
gaanth	गांठ	गांठ
ganth	गांठ	गंत
gaanthe	गांठे	गांठे
ganthe	गांठे	गंते
ganthen	गांठें	गंतेह
ganthon	गांठों	गंतों
gaen	गाएं	गाइन
gayen	गाएं	गायन
gazi	गाज़ी	गजी
gajipur	गाजीपुर	गैजिरो
gazipur	गाजीपुर	गैजिरो
gayatri	गायत्री	गायरती
gayitri	गायत्री	गैरिस
gaytri	गायत्री	गार्क्स
gidgidate	गिड़गिड़ाते	गिंदुष्क
ginate	गिनते	गिनलाने
ginte	गिनते	गिंते
girkar	गिरकर	गिरका
girijaghar	गिरजाघर	गिरिवाज्र
girjaghar	गिरजाघर	गिराबाजी
girijagharon	गिरजाघरों	गिरियाब्मुद्ध
girjagharon	गिरजाघरों	गिराबादीय
girati	गिरती	गिराती
girti	गिरती	गिरती
girish	गिरीश	गिरिश
guan	गुआन	गुआन
gujar	गुजार	गुजार
gujarata	गुजारता	गुजातर
gujarta	गुजारता	गुजातर
gujarate	गुजारते	गुजरते
gujarte	गुजारते	गुजरती
gujarana	गुजारना	गुजारना
gujarna	गुजारना	गुजारना
gujara	गुजारा	गुजारा
gujare	गुजारे	गुजरे
gutta	गुट्टा	गुटता
gthalidar	गुठलीदार	गहत्त्व्य
guthalidar	गुठलीदार	गुद्धसर्थी
gudna	गुदना	गुदंद
gumaan	गुमान	गुमान
guman	गुमान	गुमान
gulshan	गुलशन	गुलझाओं
gunga	गूंगा	गुनाओं
grihnagar	गृहनगर	गृहागार
gruhnagar	गृहनगर	गृहाग्य
galaxion	गैलेक्सियों	गलकितियों
galaxiyon	गैलेक्सियों	गलकितियों
galaxyon	गैलेक्सियों	गलकितों
gochar	गोचर	गोचर
gouchar	गोचर	गोचरे
godara	गोदारा	गोदारा
gopichand	गोपीचंद	गोपीपाध
gomake	गोमके	गोमने
gomke	गोमके	गोमने
goel	गोयल	गोल
goyal	गोयल	गोयल
gosvaami	गोस्वामी	गोल्मवार
gosvami	गोस्वामी	गोल्सव
goswami	गोस्वामी	गोल्सव
gaumukh	गौमुख	गौमोदी
gomukh	गौमुख	गोमदें
gaumutr	गौमूत्र	गौमती
gaumutra	गौमूत्र	गौमालकर
gowmutra	गौमूत्र	गोल्प्रवास
granthiyaan	ग्रंथियां	ग्रांडलाएं
granthiyan	ग्रंथियां	ग्रांडलाक्रिक
grandhiyon	ग्रंथियों	ग्राणियोधिक
granthiyon	ग्रंथियों	ग्रांडिकल्स
greest	ग्रीस्ट	ग्रेस्ट
greist	ग्रीस्ट	ग्रेस्टेयर
grist	ग्रीस्ट	ग्रिस्ट
greg	ग्रेग	ग्री
granite	ग्रेनाइट	ग्रेनेट
grenite	ग्रेनाइट	ग्रेंसर्क
grandson	ग्रैंडसन	ग्रांडोंस
gross	ग्रॉस	ग्रोस्स
ghataatop	घटाटोप	घटताप
ghatatop	घटाटोप	घटतों
ghataayaa	घटाया	घटाया
ghataya	घटाया	घटाया
ghanakar	घनाकार	घानकार
ghabrahat	घबराहट	घारभाता
ghasi	घासी	घसी
ghisai	घिसाई	घिसाई
ghisi	घिसी	घिसी
ghise	घिसे	घिसे
ghumakkadi	घुमक्कड़ी	घूमनदानी
ghumakkdi	घुमक्कड़ी	घूमनें
ghumakkadon	घुमक्कड़ों	घूमनदों
ghumakkaron	घुमक्कड़ों	घूमनाकार
ghumakkdon	घुमक्कड़ों	घूमनदों
ghummakkadon	घुमक्कड़ों	घूमनदोतों
ghumaan	घुमाण	घूमना
ghuman	घुमाण	घूमना
ghoonsa	घूंसा	घूंता
ghunsa	घूंसा	घूमना
ghongha	घोंघा	घोघना
ghontane	घोंटने	घोंजका
ghontne	घोंटने	घोंकते
ghot	घोट	घोट
ghodi	घोड़ी	घोड़ी
ghost	घोस्ट	घोस्त
changul	चंगुल	चैंगल
chand	चंद	चंद
chandan	चंदन	चंदान
chandana	चंदन	चंदाना
chandu	चंदू	चंदु
chandon	चंदों	चंदों
chandrabali	चंद्रबली	चंद्रसेगरी
chandramaon	चंद्रमाओं	चंद्रसाओं
chakatte	चकत्ते	चक्तते
chaktte	चकत्ते	चकते
chakkar	चक्कर	चक्कार
chkkar	चक्कर	चक्रा
chakshu	चक्षु	चक्षी
chatagaon	चटगांव	चातायन
chatgaon	चटगांव	चासनों
chadhane	चढ़ने	चढ़ाने
chadhne	चढ़ने	चढ़ने
chaturdik	चतुर्दिक	चक्त्रोचन
chatunshkoniy	चतुष्कोणीय	चौतुमंदी
chatushkoniy	चतुष्कोणीय	चक्षितियों
chatushkoniya	चतुष्कोणीय	चौतुकाशों
channa	चन्ना	चंका
chabate	चबाते	चबते
chabutare	चबूतरे	चब्बार्ज
chabutre	चबूतरे	चब्रित
chamakna	चमकना	चमकान
chamkana	चमकना	चमकाना
charas	चरस	चरास
charit	चरित	चर्कल
charcha	चर्चा	चर्चा
churcha	चर्चा	चर्चा
charchaon	चर्चाओं	चर्चों
chalenge	चलेंगे	चलेंगे
chlenge	चलेंगे	क्लेंडी
chahunaur	चहुंओर	चौहगारी
chahunor	चहुंओर	चौहनी
chanval	चांवल	चंदला
chanwal	चांवल	चंदला
chachaji	चाचाजी	चक्षे
chadar	चादर	चड़ार
chadaron	चादरों	चकड़ों
chadron	चादरों	चकड़ों
chan	चान	चन
chanan	चानन	चांका
chaplusi	चापलूसी	चापुल्स
chayal	चायल	चायल
char	चार	चर्
charon	चारों	चरों
charge	चार्ज	चर्गे
chart	चार्ट	चर्त
charton	चार्टों	चर्तों
charts	चार्ट्स	चर्तास
chaalit	चालित	चालित
chalit	चालित	चलित
chikitsak	चिकित्सक	चिक्किस्तान
chikitsakon	चिकित्सकों	चिक्किस्ताओं
chikhali	चिखली	चिखली
chiththi	चिट्ठी	चित्तीह
chitthi	चिट्ठी	चितित्व
chithhi	चिठ्ठी	चितहीद
chiththi	चिठ्ठी	चित्तीह
chitthi	चिठ्ठी	चितित्व
chidchidapan	चिडचिडापन	चिद्दिनापूर्ण
chidchidapan	चिड़चिड़ापन	चिद्दिनापूर्ण
chidhate	चिढ़ते	चिड़ते
chidhte	चिढ़ते	चिद्धते
chithrkar	चित्रकार	चित्रहानी
chitrkar	चित्रकार	चित्रकार
chipakane	चिपकने	चिपकने
chipakne	चिपकने	चिपकने
chipkane	चिपकने	चिपकने
chimati	चिमटी	चिमलन
chimti	चिमटी	चिम्निम
chillane	चिल्लाने	चिलाबाल
chee	ची	ची
chi	ची	चिक
chuka	चुका	चुका
chune	चुने	चुने
chunar	चूनर	चुनार
changed	चेंज्ड	चंगड़े
chetti	चेट्टी	चेतल
chennai	चेन्नई	चेनेना
chero	चेरो	चोर्स
chest	चेस्ट	चेस्ट
championship	चैंपियनशिप	चंपुर्शियों
chor	चोर	चोर
choro	चोरों	चोरो
choron	चोरों	चोरों
chauk	चौक	चौक
chowk	चौक	चोड़ो
chauka	चौका	चौका
chuka	चौका	चुका
chaukiyan	चौकियां	चौकायुओं
chauki	चौकी	चौकिया
chaukhate	चौखटे	चौखते
chauguni	चौगुनी	चौंगी
chauda	चौड़ा	चौड़ा
chaudah	चौड़ा	चौदाह
chaudahavan	चौदहवां	चौद्याबाद
chaudhavan	चौदहवां	चौद्याब्य
chaudhawan	चौदहवां	चौद्याब्य
chaupati	चौपाटी	चौप्तिया
chupaty	चौपाटी	चुप्ता
chaupal	चौपाल	चौम्य
chaurai	चौरई	चौरीय
chausinga	चौसिंगा	चौतयोगी
chausingha	चौसिंगा	चौदूमाओं
chhagan	छगन	छागा
chhabi	छबि	छबी
chhalla	छल्ला	छलाल
chhallaa	छल्ला	छलला
chhaviyaan	छवियाँ	छावायिक
chhaviyan	छवियाँ	छावायिक
chhavi	छवी	छावी
cheh	छह	चेह
chhah	छह	छाह
chehon	छहों	चेहों
chhahon	छहों	छाहों
chhai	छाई	छाई
chhagla	छागला	छागल
chhajan	छाजन	छाजन
chhaati	छाती	छाती
chhati	छाती	छती
chhaapemaar	छापेमार	छापतारी
chhapemar	छापेमार	छप्परी
chheenk	छींक	छेकने
chhink	छींक	छिन्न
chink	छींक	चिंक
chenkein	छींके	चेंकें
chhekein	छींके	छेकीने
chhinke	छींके	छिनेने
chhinky	छींके	छिन्नी
chinke	छींके	चिंके
chhudaane	छुडाने	छुड़ने
chhudane	छुडाने	छुड़ने
chhupakar	छुपकर	छुपकार
chhupkar	छुपकर	छुपने
chhupkr	छुपकर	छुपने
chhupata	छुपता	छुप्पता
chhupta	छुपता	छुप्पता
chhuptaa	छुपता	छुप्पता
chhura	छुरा	छुरा
chhuraa	छुरा	छुआर
chhuree	छुरी	छुरे
chhuri	छुरी	छुरी
chhure	छुरे	छुरे
chhootane	छूटने	छूकता
chhutane	छूटने	छुटने
chhutne	छूटने	छुटने
chheter	छेत्र	छेत्री
chhetr	छेत्र	छेत्र
chhetter	छेत्र	छेत्तर
chhetri	छेत्री	छेत्री
chhetthari	छेत्री	छेत्तर्व
chhetthri	छेत्री	छेत्तरी
chai	छै	चै
chhai	छै	छाई
chhe	छै	छे
jagaega	जगाएगा	जगाये
jagayega	जगाएगा	जगायी
jaghaega	जगाएगा	जगहाये
jgaayega	जगाएगा	जगायाई
jgayegaa	जगाएगा	जगायाई
jajaon	जजों	जज़यों
jajon	जजों	जाजों
jad	जड़	जड़
jadd	जड़	जद्द
jaddit	जड़ित	जद्दित
jadeite	जड़ित	जड़केले
jadet	जड़ित	जड़ते
jadit	जड़ित	जड़ित
jadein	जड़ें	जड़ीं
jaden	जड़ें	जड़ने
jatara	जतरा	जतारा
jatra	जतरा	जतार
jataati	जताती	जताती
jatatee	जताती	जताले
jatati	जताती	जताती
janagananaa	जनगणना	जनगाना
janaganna	जनगणना	जनगाना
jangadnaa	जनगणना	जन्यादान
janganana	जनगणना	जनगानान
janganna	जनगणना	जनगाना
janajagran	जनजागरण	जनराजन
janjaagran	जनजागरण	जनसंपरण
janjagran	जनजागरण	जनसंपरण
january	जनवरी	जनोरागी
janahaani	जनहानि	जनहानी
janahani	जनहानि	जनहानी
janhaani	जनहानि	जनहानी
janhani	जनहानि	जनहानी
jnhaani	जनहानि	जनहानी
jamaate	जमाती	जमाते
jamaati	जमाती	जमानी
jamati	जमाती	जमाती
jamaaya	जमाया	जमाया
jamaeya	जमाया	जमाया
jamaya	जमाया	जमाया
jamayaa	जमाया	जमाया
jamuai	जमुई	जमीबा
jamuei	जमुई	जमी
jamui	जमुई	जमी
jai	जय	जै
jay	जय	जाय
jaidayal	जयदयाल	जैडिया
jayadayal	जयदयाल	जयासाह
jaydayal	जयदयाल	जयस्या
jaibaan	जयबाण	जलने
jaiban	जयबाण	जलनी
jaybaan	जयबाण	जयनाएं
jayalalita	जयललिता	जयासितलीय
jayalalitaa	जयललिता	जयासितलीय
jayalalithaa	जयललिता	जशलिताया
jaylalita	जयललिता	जलसिला
jarakh	जरख	जरह
zarakh	जरख	जरह
jarda	जर्दा	जरदा
jardaa	जर्दा	जरदा
zarda	जर्दा	जरद
jalagati	जलगति	जलागासी
jalgati	जलगति	जलमिक
jalgti	जलगति	जलमी
jalte	जलते	जलते
jalbharav	जलभराव	जलप्रभव
jalbhraav	जलभराव	जलप्रभाव
jalbhrav	जलभराव	जलप्रभाह
jalvaayu	जलवायु	जलवायु
jalvayu	जलवायु	जलवायु
jalesar	जलेसर	जल्सर
jasmeet	जसमीत	जस्मेत
jasmit	जसमीत	जस्मती
jassee	जस्सी	जसील
jassi	जस्सी	जस्सी
jamaanaa	ज़माना	जमाना
jamana	ज़माना	जमाना
zamaanaa	ज़माना	जमाना
zamana	ज़माना	जमाना
jaljale	ज़लज़ले	जलसाजे
zalzale	ज़लज़ले	जलसाजे
zee	ज़ी	जी
jubaan	ज़ुबान	जुनाएं
juban	ज़ुबान	जूना
zuban	ज़ुबान	जूना
jaanch	जाँच	जाने
jaaunch	जाँच	जाहूग
janch	जाँच	जन
jaunch	जाँच	जौहन
jaagriti	जागृति	जाग्रिती
jagriti	जागृति	जगपिति
jagruti	जागृति	जागृति
jajamau	जाजमऊ	जजमाई
jajmau	जाजमऊ	जजमू
jajmauu	जाजमऊ	जजमूना
jaat	जात	जात
jat	जात	जत
jaatak	जातक	जातक
jatak	जातक	जताक
jaatakon	जातकों	जातकों
jaatkon	जातकों	जातकों
jatakon	जातकों	जताओं
jaatiyon	जातियों	जातियों
jatiyon	जातियों	जतियों
jaankaaron	जानकारों	जानकरों
jaankaron	जानकारों	जानकरों
jankaron	जानकारों	जनपरों
jaanam	जानम	जानम
janam	जानम	जन्म
jaayke	जायके	जायके
jayke	जायके	जायके
jaawar	जावर	जावर
zawar	जावर	जवार
jing	जिंग	जिंग
gin	जिन	गिन
jeen	जिन	जी
jin	जिन	जिन
ginee	जिनी	गिने
jinee	जिनी	जिने
jini	जिनी	जिनी
geneva	जिनीवा	गेनेवा
jeneva	जिनीवा	जेनेवा
jiniva	जिनीवा	जिंचाव
gypsy	जिप्सी	ग्माय
jimme	जिम्मे	जिम्मी
jiya	जिया	जिया
gic	जीआईसी	गिय
gr	जीआर	ग्र
gm	जीएम	ग्म
gsm	जीएसएम	ज्यम
gtod	जीतोड़	ग्वॉट
gtor	जीतोड़	ग्रॉफ
jeetod	जीतोड़	जीड़तो
jitod	जीतोड़	जिद्स
jean	जीन	जेन
jeen	जीन	जी
jin	जीन	जिन
jeenon	जीनों	जीनों
jinon	जीनों	जिनों
jeepney	जीपनी	जीपके
jipani	जीपनी	जिप्पा
jeeyo	जीयो	जीयो
jio	जीयो	जो
jiyo	जीयो	जियो
jeera	जीरा	जीरा
jira	जीरा	जिरा
jeevant	जीवंत	जीवांत
jivant	जीवंत	जितावं
jeevan	जीवन	जीवान
jeewan	जीवन	जीवान
jivan	जीवन	जिवान
jiwan	जीवन	जिवान
jeevanshaili	जीवनशैली	जीवामविल्प
jivanshaili	जीवनशैली	जिलवाग्रहम
jeevniyaan	जीवनियां	जीवनियां
jivaniya	जीवनियां	जिवानार्य
jivaniyaan	जीवनियां	जिवानापूर्ण
jivaniyan	जीवनियां	जिवानियों
jeevraaj	जीवराज	जीवराज
jivraj	जीवराज	जिवर
jua	जुए	जूय
jue	जुए	जू
juye	जुए	जूए
jutee	जुटी	जूते
juti	जुटी	जूती
judaai	जुड़ाई	जुड़ाए
judae	जुड़ाई	जुड़ा
judai	जुड़ाई	जुड़ाए
judaai	जुदाई	जुड़ाए
judai	जुदाई	जुड़ाए
junoon	जुनून	जूनों
junun	जुनून	जुनून
junooni	जुनूनी	जुनूनी
jununi	जुनूनी	जुनूनी
jubair	जुबेर	जुबरी
juber	जुबेर	जुबर
zubair	जुबेर	जुगरे
juraab	जुराब	जुराब
jurab	जुराब	जुराब
julaahon	जुलाहों	जुलायों
julahon	जुलाहों	जुल्यदों
julmon	जुल्मों	जूलमों
zulmon	जुल्मों	जूलमों
jood	जूड	जूड़
jud	जूड	जूड़
junagadh	जूनागढ	जुनायद
junagarh	जूनागढ	जुनावर
junior	जूनियर	जुनिरो
jealous	जूलूस	जील्स
juloos	जूलूस	जूल्स
julus	जूलूस	जूल्सू
jetha	जेठा	जेता
jenner	जेनर	जेनेर्स
generic	जेनरिक	जेनेरिक
jenrick	जेनरिक	जेरीन
generat	जेनरेट	जेंकर्म
generate	जेनरेट	जेंकर्मर
jenee	जेनी	जेने
jenni	जेनी	जेनिन
jenny	जेनी	जेनन
james	जेम्स	जमी
jeremy	जेरेमी	जीरमी
gerome	जेरोम	ग्रीम
jerome	जेरोम	जर्जी
jacks	जैक्स	जैक्स
jain	जैन	जैन
gene	जैने	जेने
jaine	जैने	जैने
jaino	जैनों	जैनो
jainon	जैनों	जैनों
jerry	जैरी	ज्री
jasper	जैस्पर	जास्पेर
jogging	जॉगिंग	जागों
johnson	जॉनसन	जोहनों
jobs	जॉब्स	जॉब्स
jockey	जोकि	जोकी
joki	जोकि	जोकी
jokhim	जोखिम	जोखमी
joddta	जोड़ता	जोड़ता
jodta	जोड़ता	जोड़ता
jorhta	जोड़ता	जोर्चता
jodiyon	जोड़ियों	जोड़ियों
jodo	जोड़ो	जोड़ो
jaun	जौं	जौन
gyatavya	ज्ञातव्य	ग्यावता
gyatvy	ज्ञातव्य	ग्यावत
gyapit	ज्ञापित	ज्ञात्रों
jyotiba	ज्योतिबा	जुलनाओं
joint	ज्वाइंट	जोनेस
jvar	ज्वार	ज्वार
jwar	ज्वार	ज्वार
jvaaron	ज्वारों	ज्ञावरों
jvaron	ज्वारों	ज्ञादोरी
jwaron	ज्वारों	ज्वरों
jewellers	ज्वेलर्स	ज्वल्सर्स
jh	झ	झ
jha	झ	झा
jhalakti	झलकती	झलकती
jhalkati	झलकती	झलकती
jhalla	झल्ला	झलाल
jhankana	झांकना	झंकाना
jhankna	झांकना	झंकान
jheel	झील	झेल
jhil	झील	झील
jheelon	झीलों	झेलों
jhilon	झीलों	झिलों
jhuthala	झुठला	झुलझाया
jhuthla	झुठला	झुलझा
jhuthalane	झुठलाने	झुलझाने
jhuthlane	झुठलाने	झुलझाने
tankaar	टंकार	तंकार
tankar	टंकार	तंकार
takara	टकरा	ताकारा
takra	टकरा	ताकर
takaraon	टकरावों	ताक्रणों
takravon	टकरावों	ताक्रियों
tapakti	टपकती	तपटकी
tapkati	टपकती	तपटकी
time	टाइम	तीमा
timer	टाइमर	तिज़ीर
taoo	टाऊ	टॉक
tau	टाऊ	टॉक
tapoowo	टापुओं	तपूदी
tapuon	टापुओं	तपून
tapuwo	टापुओं	तपूव
tied	टायर्ड	तीड़
tired	टायर्ड	तिर्च
tyred	टायर्ड	त्रीड
tarch	टार्च	तर्च
torch	टार्च	टर्च
tik	टिक	टीक
teap	टिप	टेप
tip	टिप	टीपी
tippanikar	टिप्पणीकार	तिप्पाकारिक
tippnikar	टिप्पणीकार	टिप्पेंसन
tivolee	टिवोली	तिवर्सी
tivoli	टिवोली	तिवर्स
teekamgarh	टीकमगढ़	तीर्थया
tikamgarh	टीकमगढ़	तिकामावार
teekon	टीकों	टीकाकों
tikon	टीकों	टिकों
two	टु	ट्वो
tension	टेंशन	टेंसियों
tenis	टेनिस	टेंगिस
tennis	टेनिस	टेंकिस
taste	टेस्ट	तस्ते
test	टेस्ट	टेस्ट
tasting	टेस्टिंग	तस्तिन
testing	टेस्टिंग	टेस्टिंग
tainin	टैनिन	टैंकिंग
tenin	टैनिन	टेंकी
tanish	टैनिस	टैंग्स
tennis	टैनिस	टेंकिस
taboo	टैबू	टाइन
taiboo	टैबू	टैंग
taobao	टैबू	तौनय
tonic	टॉनिक	टोनियों
tonga	टोंगा	टोगन
toka	टोका	टोका
tuesday	ट्यूजडे	तुल्डा
tuning	ट्यूनिंग	ट्यूनिंग
tuberculosis	ट्यूबरक्यूलोसिस	तुलपुरमुमी
tuberkyulosis	ट्यूबरक्यूलोसिस	तुल्पित्सिरी
truck	ट्रक	ट्रूक
trangistor	ट्रांजिस्टर	ट्रांसिस
tranjister	ट्रांजिस्टर	ट्रांसप्रेट्स
transistor	ट्रांजिस्टर	ट्रांसिस्टर
transfer	ट्रान्सफर	ट्रांसर्स
tribunal	ट्रिब्युनल	ट्रिबिकल
tribunal	ट्रिब्यूनल	ट्रिबिकल
trubyunal	ट्रिब्यूनल	ट्रॉबिलाइन
truth	ट्रुथ	ट्रेड
tuth	ट्रुथ	तुथ
traded	ट्रेडेड	ट्रेड
trabal	ट्रेबल	ट्रेमार
trebal	ट्रेबल	ट्रेबर्स
trouble	ट्रेबल	ट्रोब्लूर
traip	ट्रैप	ट्रेंस
trap	ट्रैप	ट्रेन
trot	ट्रॉट	ट्रॉफ
trott	ट्रॉट	ट्रॉफ्ट
thakkar	ठक्कर	ठक्कार
thakkr	ठक्कर	ठक्कर
thaharne	ठहरने	ठहरने
thahrane	ठहरने	ठहराने
theharne	ठहरने	ठहराने
thikane	ठिकाने	थिकाने
thumari	ठुमरी	थुमरी
thumri	ठुमरी	थमरू
theinga	ठेंगा	थेकिया
thenga	ठेंगा	थेना
thengaa	ठेंगा	थेना
daglas	डगलस	दमासी
douglas	डगलस	डोमियल
dabhara	डभरा	दबार्ह
dabhra	डभरा	दबर्ड
dabhoi	डभोई	दबोची
dam	डम	दम
dum	डम	डूम
darate	डराते	दरते
daratey	डराते	दरता
daravani	डरावनी	दरवानी
darawani	डरावनी	दरवानी
dravani	डरावनी	द्रव्यन
down	डाउन	डोड़ोग
daak	डाक	दाक
dak	डाक	दक
daka	डाका	दका
dabi	डाबी	डबी
dabolim	डाबोलिम	डॉबिल
dinosaur	डायनासोर	दिनोलिया
diaries	डायरीज	डिरली
dit	डिट	डित
depthiriya	डिप्थीरिया	देपार्वित
diphtheria	डिप्थीरिया	दिभारहित
de	डीई	डे
dealership	डीलरशिप	दीवासिपूर्ति
dvc	डीवीसी	द्वी
dubaana	डुबाना	दुबाना
dubana	डुबाना	दुबाना
dubona	डुबोना	दूबना
dulne	डुलने	डलने
doonarpur	डूंगरपुर	दूनिरा
doongarpur	डूंगरपुर	दूनिरान
dungarpur	डूंगरपुर	दुनरीय
dungerpur	डूंगरपुर	डिग्रेन
dubana	डूबना	दुबाना
dubna	डूबना	डब्बा
dangerous	डेंजरस	दंग्रिती
daisy	डेजी	दैसी
dazy	डेजी	दास
deji	डेजी	डेजिय
deputy	डेप्युटी	डेब्रोम
davidson	डेविडसन	दवितों
devidson	डेविडसन	देवदस्यों
davey	डेवी	दवायी
devi	डेवी	देवी
dewey	डेवी	देवर
destination	डेस्टिनेशन	डेस्केशन
datson	डैटसन	दतों
datsun	डैटसन	दतूमन
daddy	डैडी	दाद्य
dark	डॉर्क	दरक
dork	डॉर्क	डोर्ड
dose	डोज	डोसे
domenic	डोमेनिक	डोमेंस
doranda	डोरंडा	दोरंदार
dolane	डोलने	डायबाते
dolne	डोलने	डॉलेंस
dual	ड्युअल	दुला
duak	ड्यूक	दुका
duke	ड्यूक	डक
drame	ड्रामे	ड्रेम
dramen	ड्रामे	ड्रेनम
drager	ड्रेजर	ड्रेग
dredger	ड्रेजर	ड्रेवेंस
dreijer	ड्रेजर	ड्रेसेब
dhakaal	ढकाल	ढकाला
dhakal	ढकाल	ढकाल
dhakkal	ढकाल	ढकाती
dhkal	ढकाल	ढकाल
dhale	ढले	ढला
dhoondh	ढूंढ	धूंढ
dhundh	ढूंढ	ढूंढा
dhoondhata	ढूंढता	धूनकाहाज
dhundhata	ढूंढता	धुंधता
dhundhta	ढूंढता	धुंधता
dhoondhi	ढूंढी	धूंढी
dhundhi	ढूंढी	धुंधी
tanjavur	तंजावुर	तंगावेजी
thanjavur	तंजावुर	ठंगावेल
tantr	तंत्र	टंटर
tantra	तंत्र	तंत्र
tantrikao	तंत्रिकाओं	तंत्रिका
tantrikaon	तंत्रिकाओं	तंत्रिका
tantro	तंत्रों	टंटोर
tantron	तंत्रों	टंटोरों
tagade	तगड़े	तगड़े
tagde	तगड़े	तंडे
tadipaar	तड़ीपार	तावपु
tadipar	तड़ीपार	तावपूर
tani	तनी	टैंक
tapan	तपन	तपान
tarafa	तरफा	तारता
tarfa	तरफा	तारता
tarabganj	तरबगंज	तर्माने
taras	तरस	तार्स
taraash	तराश	तराश
tarash	तराश	तर्श
tarashay	तराशे	तर्याश
tarashe	तराशे	तराशे
tareeko	तरीको	तरीक
tariko	तरीको	तरीक
tark	तर्क	तरक
tarkvaad	तर्कवाद	तर्दाधिया
tarkvad	तर्कवाद	तर्दाधिक
tarkwaad	तर्कवाद	तर्दाधिया
tarko	तर्कों	तरकों
tarkon	तर्कों	तरकों
talabgaar	तलबगार	तलनेगा
talabgar	तलबगार	तलपारी
talbagaar	तलबगार	तलबागार
talbagar	तलबगार	तलबागार
talawe	तलवे	तलवार
talve	तलवे	तलवे
talawon	तलवों	तलवों
talvon	तलवों	तलोदी
tahakhana	तहखाना	तहकाड़ने
tahkhaana	तहखाना	तहकाड़े
tahkhana	तहखाना	तहाड़ने
taantaa	तांता	तांता
tanta	तांता	तनता
tambe	तांबे	तमी
tanbe	तांबे	टैंब
taaja	ताजा	ताजा
taajaa	ताजा	ताजा
taaza	ताजा	ताजा
taja	ताजा	ताजा
taza	ताजा	ताजा
tansen	तानसेन	टंसें
taapmaanon	तापमानों	तामपानों
tapmano	तापमानों	तामपों
tapmanon	तापमानों	तामपों
taapti	ताप्ती	तापित
tapti	ताप्ती	तपटी
tarabai	ताराबाई	तराबारी
taseer	तासीर	तासीर
tasir	तासीर	तस्री
taahi	ताहि	ताही
tahi	ताहि	तही
tikone	तिकोने	टिक्नून
tirupati	तिरूपति	तोरिंगल
tiwari	तिवारी	तिवरी
ti	ती	टी
teer	तीर	टेर
tir	तीर	तीर
teeron	तीरों	टीरों
tiron	तीरों	तिरों
tirthatan	तीर्थाटन	तीर्थंता
tungnath	तुंगनाथ	टंगड़े
tughlaq	तुगलक	तुश्बानी
tuglak	तुगलक	टमेंस
tughlakabad	तुगलकाबाद	वुम्यानुका
tughlaqabad	तुगलकाबाद	वुम्यानुका
tuglakabad	तुगलकाबाद	तुमाबड़ियां
tugalaki	तुगलकी	टुमानिया
tugalki	तुगलकी	टुगलिक
tuglaki	तुगलकी	टाइमनिक
tufail	तुफैल	तुलासी
tejaji	तेजाजी	टेजल
teji	तेजी	टेजी
tel	तेल	टेल
telon	तेलों	टेलों
to	तो	टू
toh	तो	टोह
taul	तौल	तौल
tyohaar	त्यौहार	ट्यूरा
tyohar	त्यौहार	ट्यूरा
tyoihar	त्यौहार	ट्यूरव
tyauharon	त्यौहारों	टुआयवानी
tyoharon	त्यौहारों	ट्यूरोदन
tyoiharon	त्यौहारों	ट्यूरियाद
trijata	त्रिजटा	ट्रेस्टा
trijta	त्रिजटा	ट्रेस्टा
triya	त्रिया	त्रिया
tremasik	त्रैमासिक	त्रिमापुत
trimasik	त्रैमासिक	त्रिमिताओं
tse	त्से	ट्यू
thaki	थकी	ठाकी
thki	थकी	थेकी
tharti	थर्टी	थर्कल
thirty	थर्टी	थिरत
thane	थाणे	ठाने
thaanvi	थानवी	ठावी
thanvi	थानवी	ठांवी
theateron	थिएटरों	ठत्करी
theatron	थिएटरों	थक्तरों
theaters	थिएटर्स	ठेत्तरी
theater	थियेटर	ठेते
theatre	थियेटर	ठेतरे
theateron	थियेटरों	ठत्करी
theatron	थियेटरों	थक्तरों
thitron	थियेटरों	थित्रों
theaters	थियेटर्स	ठेत्तरी
theatrs	थियेटर्स	ठेत्र
thiyeters	थियेटर्स	थिरित्ति
thirake	थिरके	थर्के
thirke	थिरके	थिरके
thief	थीफ	थील
then	थेन	थेन
theni	थेनी	थेनी
thailee	थैली	थली
thaili	थैली	थली
thaile	थैले	थली
dang	दंग	दंग
danga	दंगा	दंगा
dangon	दंगों	दंगों
dampati	दंपति	दम्पता
danpati	दंपति	दंपती
dampatiyon	दंपतियों	दम्प्तियों
dampattiyon	दंपतियों	दम्प्तियां
danptiyon	दंपतियों	दंतपूर्ण
dadreva	ददरेवा	दादरीय
dadrewa	ददरेवा	दादरीय
damoh	दमोह	दमोद
dardara	दरदरा	दरादार
dardraa	दरदरा	दरादार
durdhara	दरदरा	दुर्धवा
darmiyaan	दरमियान	दर्मियां
darmiyan	दरमियान	दर्मियां
darjano	दर्जनों	दर्मान
darjanon	दर्जनों	दर्मकांक
darp	दर्प	डर्न
darra	दर्रा	दरार
dalbadal	दलबदल	दलबाला
dalbadl	दलबदल	दलब्बा
dali	दली	डाली
dastaanaa	दस्ताना	दस्तना
dastana	दस्ताना	दस्तना
dastavej	दस्तावेज	दस्ताले
dahan	दहन	दहन
dahal	दहल	दहाल
da	दा	दा
daakhil	दाखिल	दाखील
dakhil	दाखिल	दैखी
daakhile	दाखिले	दाखीले
dakhile	दाखिले	दैखील
daataa	दाता	दाता
data	दाता	दाता
dadari	दादरी	दादरी
daanshil	दानशील	दांसिश
danshil	दानशील	दंशील
daabholkar	दाभोलकर	दाबाचलों
dabholkar	दाभोलकर	दब्हुनता
damale	दामले	दमला
damle	दामले	दमले
dayitv	दायित्व	दायशि
dayitva	दायित्व	दायशाया
dayitwa	दायित्व	दायशकर
dayitvon	दायित्वों	दायक्षियों
dayityon	दायित्वों	दायकासिक
darul	दारूल	दर्शी
daav	दाव	दाव
daaw	दाव	दाव
dav	दाव	दव
daw	दाव	दव
daah	दाह	दाह
dah	दाह	दाह
dikhla	दिखला	दिखल
dikhlaa	दिखला	दिखला
dikhaaiye	दिखाइये	दिखाइया
dikhaiye	दिखाइये	दिखाइया
dikhaai	दिखाई	दिखाई
dikhai	दिखाई	दिखाई
dikhayi	दिखाई	दिखायी
dikhaaee	दिखाईं	दिखाए
dikhaai	दिखाईं	दिखाई
dikhaain	दिखाईं	दिखाइन
dikhaee	दिखाईं	दिखाए
dikhai	दिखाईं	दिखाई
dikhayin	दिखाईं	दिखायी
dikhai	दिखायी	दिखाई
dikhayi	दिखायी	दिखायी
dikhaai	दिखार्इ	दिखाई
dikhae	दिखार्इ	दिखाए
dikhai	दिखार्इ	दिखाई
dikhayi	दिखार्इ	दिखायी
dita	दिता	दिता
ditaa	दिता	दिता
dinaank	दिनांक	दिनाकान
dinank	दिनांक	दिनाक
dirham	दिरहम	दीर्घास
dilaaye	दिलाये	दिलाये
dilaye	दिलाये	दिलाये
deewani	दिवानी	दीवानी
diwani	दिवानी	दिवानी
divy	दिव्य	दिवस
divya	दिव्य	दिवाया
divyata	दिव्यता	दिवसाया
divya	दिव्या	दिवाया
deepan	दीपन	दीपान
deepn	दीपन	डेप्क
dipan	दीपन	डापने
deepsingh	दीपसिंह	दीप्शिय
dipsingh	दीपसिंह	दिप्रमोहों
deepika	दीपिका	दीपानी
dipika	दीपिका	दिपिका
deeya	दीया	दीया
diya	दीया	दिया
dukaanon	दुकानों	दुकानों
dukanon	दुकानों	दुकानों
dukke	दुक्के	डककें
dukhan	दुखन	दुखन
dukhit	दुखित	दुखित
dukhiyon	दुखियों	दुखों
dukhon	दुखों	दुखों
dubhashiyon	दुभाषियों	दुभागितियों
durgun	दुर्गुण	दुर्गियों
durghatna	दुर्घटना	दृमकांडे
durghtna	दुर्घटना	दुर्घकात
duneerti	दुर्नीति	डंबर्स
durniti	दुर्नीति	दुर्बित
durbhiksh	दुर्भिक्ष	दुर्बेद्धित
duvidhaaen	दुविधाएं	दुविधान
duvidhaayein	दुविधाएं	दुविधाविद
duvidhaen	दुविधाएं	दुवेद्रों
duwaidhaayein	दुविधाएं	दुवावादीय
dune	दूने	डूने
doordarshan	दूरदर्शन	दूरदर्शन
durdarshan	दूरदर्शन	दुर्धवास
dradh	दृढ़	द्राद
dridh	दृढ़	दृहद
dekhoge	देखोगे	देखून
denevaali	देनेवाली	देनावली
denevali	देनेवाली	देनेवाली
denewaali	देनेवाली	देनावली
denewali	देनेवाली	देनेवाली
deonar	देवनार	देयपा
devnaar	देवनार	देवाना
devnar	देवनार	देवांग
devaapur	देवापुर	देवापूर्ण
devapur	देवापुर	देवापूर्ण
devi	देवी	देवी
devisingh	देवीसिंह	देविजीव
devisinh	देवीसिंह	देविजीव
deshkaal	देशकाल	देशताएं
deshkal	देशकाल	देशती
deshke	देशके	देशके
desai	देसाई	डेसिया
doge	दोगे	डोग
dvadash	द्वादश	द्वाद्य
dwaadas	द्वादश	द्वादास
dvivedi	द्विवेदी	द्विविध
dwivedi	द्विवेदी	द्विविध
dhande	धंधे	ढंदे
dhandhe	धंधे	ढंदेह
dhndhe	धंधे	ढेंदे
dhandhon	धंधों	ढंदोदी
dhandon	धंधों	धंडों
dhakelte	धकेलते	ढकेतेल
dhkelate	धकेलते	ढकेतेते
dhatana	धटना	धाताना
dhatna	धटना	धातान
dhankuber	धनकुबेर	ढांकुरे
dhanadhany	धनधान्य	ढांधना
dhandhaanya	धनधान्य	ढंदादार
dhandhany	धनधान्य	ढंदादी
dhandhanya	धनधान्य	ढंदादार
dhamkaataa	धमकाता	धमकाता
dhamkata	धमकाता	धमकाता
dhamm	धम्म	धम्म
dhamma	धम्मा	धम्मा
dhammaa	धम्मा	धम्मा
dharmnath	धर्मनाथ	धर्मदात
dharmraj	धर्मराज	धर्माल
dharmesh	धर्मेश	धर्मित
dhasmaanaa	धस्माना	धस्मान
dhasmana	धस्माना	धस्मान
dhaak	धाक	ढक
dhak	धाक	ढक
dhaaga	धागा	ढांगा
dhaagaa	धागा	ढागा
dhaga	धागा	ढागा
dhaatuein	धातुएं	धाकुती
dhaatuyein	धातुएं	धाकुलिक
dhtuen	धातुएं	धुक्मक
dhaarak	धारक	धारक
dharak	धारक	धारक
dhaari	धारी	धारी
dhari	धारी	धरी
dhuan	धुआं	ढूक
dhunaai	धुनाई	धुनाई
dhunai	धुनाई	धुनाई
dhuriya	धुरिया	धुरुया
dhuriyaa	धुरिया	धुरुया
dhuni	धूनी	धूनी
dhairyavaan	धैर्यवान	धैर्यवाण
dhairyawan	धैर्यवान	धार्यवाणी
dhiryavan	धैर्यवान	धीरोधाओं
dhiryawaan	धैर्यवान	धीरोधाओं
dhokebaaj	धोखेबाज	ढोकाबल
dhokebaaz	धोखेबाज	ढोकाबल
dhokebaj	धोखेबाज	ढोकेजा
dhokebaz	धोखेबाज	ढोकेजा
dhokhebaaj	धोखेबाज	ढोखभाते
dhokhebaj	धोखेबाज	ढोखभाते
dhona	धोना	ढोना
dhonaa	धोना	ढोना
dhoraaji	धोराजी	धोरल
dhoraji	धोराजी	धोरल
dhoron	धोरों	धोरों
dhyeyavaadi	ध्येयवादी	ध्यायदीव
dhyeywadi	ध्येयवादी	ध्यविद्व
dyeyvadi	ध्येयवादी	द्यीयोधा
dhrupad	ध्रुपद	धर्नवाद
drupad	ध्रुपद	दृहन
nandanvan	नंदनवन	नंदड़वान
nadsa	नक्सल	नादसा
naksal	नक्सल	नकासल
naxal	नक्सल	नकला
naksalavaad	नक्सलवाद	नक्शावसार
naksalwaad	नक्सलवाद	नक्शावसार
naksalwad	नक्सलवाद	नक्शवास
naxalvaaad	नक्सलवाद	नक्तवालय
naxalwaad	नक्सलवाद	नक्तवालय
naksaliyon	नक्सलियों	नकासियालिक
naxaliyon	नक्सलियों	नक्तियासिक
naksali	नक्सली	नकासील
naxali	नक्सली	नकलाली
nagaada	नगाड़ा	नगादा
nagaadaa	नगाड़ा	नगादा
nagaaraa	नगाड़ा	नगरा
nageene	नगीने	नागें
nagine	नगीने	नागिक
najarandaaj	नजरंदाज	नजरत्का
najarandaaz	नजरंदाज	नजरत्का
nazarandaaj	नजरंदाज	नजरंदता
nazarandaaz	नजरंदाज	नजरंदता
nazarandaz	नजरंदाज	नजरंदता
najraane	नजराने	नज़राने
nazraane	नजराने	नज़राने
najariyon	नजरियों	नजरीय
najriyon	नजरियों	नजरीका
najron	नजरों	नज़ोरों
najeeb	नजीब	नज़ी
najib	नजीब	नजी
najibabaad	नजीबाबाद	नजीबादार
najibabad	नजीबाबाद	नजीबादार
najeem	नजीम	नज़ील
najim	नजीम	नज़मी
nazeem	नजीम	नज़ील
nana	नना	नाना
nanaa	नना	नाना
nna	नना	नान
nanhe	नन्हें	नाहे
nanhein	नन्हें	नाहें
nabj	नब्ज़	नाब
nabja	नब्ज़	नब्जा
nabz	नब्ज़	नाब
namkeen	नमकीन	नंबक
namkin	नमकीन	नमकीन
narnaari	नरनारी	नर्बाने
narnari	नरनारी	नर्बार
narbhakshi	नरभक्षी	नर्नाधित्री
naram	नरम	नरम
narm	नरम	नमर
narmi	नरमी	नर्मी
narsanhar	नरसंहार	नर्दांबा
narsanharon	नरसंहारों	नर्शनिका
november	नवंबर	नॉल्प्रो
navketan	नवकेतन	नवकालक
navjaagaran	नवजागरण	नवसंगार
navjagran	नवजागरण	नवसंग्रह
navdha	नवधा	नवदा
navvadhoo	नववधू	नवदोवी
navvadhu	नववधू	नवदौव
nava	नवा	नवा
navaa	नवा	नवा
navate	नवाते	नवाते
navanagar	नवानगर	नवानगर
nawanagar	नवानगर	नवानगर
navya	नव्या	नवाया
naseem	नसीम	नसीम
nasim	नसीम	नस्मी
nights	नाइट्रस	निज़मी
nitrous	नाइट्रस	नित्रुम
nineteez	नाइनटीज	निंकतेजी
nineties	नाइनटीज	निंकितिमार
ninties	नाइनटीज	निंटील
nau	नाऊ	नौ
nauu	नाऊ	नौऊ
naakaam	नाकाम	नाकाम
nakam	नाकाम	नकाम
naagrik	नागारिक	नागपूर्ण
nagarik	नागारिक	नगरीक
nagrik	नागारिक	नागरीक
nagin	नागिन	नागिक
nadep	नाडेप	नादपे
nanak	नानक	नंका
nanavati	नानावती	नंदालि
napane	नापने	नापने
napne	नापने	नापें
napa	नापा	नाप
naam	नाम	नाम
naamdhari	नामधारी	नंदर्शी
namdhari	नामधारी	नमर्भ
namankano	नामांकनों	नमकानों
namankanon	नामांकनों	नमकानों
namavaliyon	नामावलियों	नमावसुनीय
naamo	नामो	नामो
namo	नामो	नमो
nayak	नायक	नयक
naraji	नाराजी	नर्जी
naraingarh	नारायणगढ़	नरीगाहार
narayangadh	नारायणगढ़	नर्याप्धा
narayangarh	नारायणगढ़	नर्यान्वर
naasar	नासर	नारास
nahargadh	नाहरगढ	नहरपाव
nahargarh	नाहरगढ	नहरपुर
nikalegi	निकलेगी	निकामी
nikalogi	निकलेगी	निकलीय
nikaalani	निकालनी	निकालनीय
nikaalni	निकालनी	निकालिन
nikalani	निकालनी	निकलनीय
nikalni	निकालनी	निकलीन
nicki	निकी	निकाइ
nicky	निकी	निकाय
niki	निकी	निकी
niketan	निकेतन	निकालने
nikhar	निखर	निकार
nikhari	निखरी	निकारी
nigar	निगर	निगार
nigger	निगर	निग्री
nichala	निचला	निचाल
nichalaa	निचला	निचाला
nichla	निचला	निचल
nitiyon	नितियों	नित्कीय
nitya	नित्या	नित्या
nityaa	नित्या	नित्या
nidhaan	निधान	निदानी
nidhan	निधान	निदानी
nipatara	निपटारा	निपारता
niptaara	निपटारा	निपटारा
niptaaraa	निपटारा	निपटारा
niptara	निपटारा	निपटारा
niyanta	नियंता	नियानता
niyantaa	नियंता	नियानता
niya	निया	निया
niyaa	निया	निया
nirdeshika	निर्देशिका	निर्देशिक
nirdeshikaa	निर्देशिका	निर्देशिका
nirdhaarit	निर्धारित	निर्देशिका
nirdharit	निर्धारित	निर्देशिक
nirbaadh	निर्बाध	निर्भा
nirbadh	निर्बाध	निर्भा
niveshakartaa	निवेशकर्ता	निवारकाश्तार
niveshkarta	निवेशकर्ता	निष्कालिकार
niveshkartaa	निवेशकर्ता	निष्कालिकार
nischal	निश्चल	निस्थिय
nishchal	निश्चल	निश्चल
nishnaat	निष्णात	निष्मक
nishpaap	निष्पाप	निर्मदार
nihalaani	निहलानी	निहालनीय
nihlaani	निहलानी	निहालनी
nihlani	निहलानी	निहाबित
nihaalchand	निहालचंद	निहालना
nihalchand	निहालचंद	निहालना
neechaaee	नीचाई	निचेहा
nichaai	नीचाई	निचाई
neat	नीट	न्या
neet	नीट	नीत
neetiyon	नीतियों	निक्सियों
nitiyon	नीतियों	नित्कीय
neelagaay	नीलगाय	निलाया
nilgai	नीलगाय	निलगाई
neelaabh	नीलाभ	नीलाहा
nilaabh	नीलाभ	निलाबाद
nilabh	नीलाभ	निलाब
nuskhe	नुस्खे	न्यूचेट
noon	नून	नून
nun	नून	नुन
noobiyaa	नूबिया	नूबिया
nubiya	नूबिया	नुबाई
nrityashaili	नृत्यशैली	नृत्वालियाम
nrutyashaili	नृत्यशैली	नृत्यावसीला
nrityon	नृत्यों	न्रासियों
nrutyon	नृत्यों	नर्सूक
neco	नेको	नेओ
neko	नेको	नेको
nectar	नेक्टर	नेक्टर
neg	नेग	नेग
nega	नेग	नेगा
networking	नेटवर्किग	नेत्रोहिक
neto	नेटो	नेटो
neta	नेता	नेता
nemo	नेमो	नेमो
nelsan	नेल्सन	नेस्सन
nelson	नेल्सन	नेस्टिंग
nations	नेशंस	नतियों
nehara	नेहरा	नहरा
nehra	नेहरा	नेहरा
naino	नैनो	नानो
nano	नैनो	नांग
naivedh	नैवेद्य	नैवेद
naivegh	नैवेद्य	नाइवगी
nevedya	नैवेद्य	निवादा
nominate	नॉमिनेट	नंबुत
naukari	नोकरी	नौकरीय
naukri	नोकरी	नौकरी
nokari	नोकरी	नोकरी
nokri	नोकरी	नॉकरी
notes	नोट्स	नॉत्स
nora	नोरा	नोरा
nori	नोरी	नॉर्स
nauner	नौनेर	नौरे
nauvahan	नौवहन	नौध्याया
naushad	नौशाद	नौसदा
panchaang	पंचांग	पंचाय
panchang	पंचांग	पंचाय
punchang	पंचांग	पूनिक
punjab	पंजाब	पूनाते
punjabiyon	पंजाबियों	पुनासियों
pantar	पंटर	पंतार
panter	पंटर	पंत्री
punter	पंटर	पुंतर
pakaayein	पकाएं	पकाएगा
pakaayen	पकाएं	पकाने
pakaen	पकाएं	पकने
pakayen	पकाएं	पकाने
pakaude	पकौड़े	पकड़े
pakshapat	पक्षपात	पक्षपत
pakshpaat	पक्षपात	पक्षपत
pakshpat	पक्षपात	पक्षपत्र
pagabadha	पगबाधा	पगखाड़े
pagbadha	पगबाधा	पंघाहा
pagalaa	पगला	पगालय
pagla	पगला	पगला
pachaataa	पचाता	पचाता
pachata	पचाता	पचाता
patakkar	पटककर	पतकाकर
patkathaayein	पटकथाएं	पटकेशका
patkathaein	पटकथाएं	पटकांठे
patkathayen	पटकथाएं	पटकाशक
patki	पटकी	पत्की
pataraani	पटरानी	पतरणा
patrani	पटरानी	पत्राएं
patavaari	पटवारी	पावलर
patwari	पटवारी	पावर्स
pataakshep	पटाक्षेप	पट्ठपक्र
patachep	पटाक्षेप	पत्कर
patakshep	पटाक्षेप	पत्तपूर्ण
patiya	पटिया	पत्याई
patiyaa	पटिया	पत्याई
padaraunaa	पडरौना	पादरूना
padrauna	पडरौना	पदर्यांच
padega	पड़ेगा	पादगी
padegaa	पड़ेगा	पादगाई
padha	पढ़ा	पढ़ा
padhaa	पढ़ा	पढ़ा
padhaataa	पढ़ाता	पढ़ता
padhata	पढ़ाता	पढ़ता
patili	पतीली	पतिली
padamawati	पदमावती	पद्मभाग्य
padmavati	पदमावती	पद्मावती
padmawati	पदमावती	पद्मावती
padadhikari	पदाधिकारी	पद्धाकारी
panapnaa	पनपना	पांकाप
panpana	पनपना	पंकार
panaamaa	पनामा	पांगामा
panama	पनामा	पांगाम
paneer	पनीर	पापेर
pammi	पम्मी	पाम्सी
pammu	पम्मी	पम्यूम
pummi	पम्मी	पुस्मी
pummy	पम्मी	पुम्मो
pardesiyon	परदेसियों	पर्दिसियों
pardesi	परदेसी	पर्दील
parva	परवा	परव
parvaa	परवा	परवा
parwa	परवा	परव
parwaa	परवा	परवा
paraadheen	पराधीन	परखेंद्र
paraadhin	पराधीन	पराधिक
paradheen	पराधीन	परखेंद्र
paradhin	पराधीन	परखों
parikalpit	परिकल्पित	परिक्षणित
parimal	परिमल	परिमाल
parishad	परिषद	परिक्षा
parishadiy	परिषदीय	परियावित
parishadiya	परिषदीय	परियावर्ती
parishadon	परिषदों	परिक्षाओं
parikhaen	परीक्षाएं	परखेंदार
parikshaayein	परीक्षाएं	परिक्षार्चिक
parikshaen	परीक्षाएं	परिचक्ति
parosane	परोसने	पर्यात्मी
parosne	परोसने	परोटी
parda	पर्दा	परद
pardaa	पर्दा	परदा
purple	पर्पल	पूर्णीम
palatne	पलटने	पलकते
paltane	पलटने	पल्नता
palaari	पलारी	पलारी
palari	पलारी	पलारी
pale	पले	पले
palmonari	पल्मोनरी	पल्पोलिया
pulmonary	पल्मोनरी	पूल्मापुर
plus	पल्स	प्लोल
pulse	पल्स	पल्ले
pashtun	पश्तून	पष्टिंग
pashtuun	पश्तून	पष्टियों
pahan	पहन	पहन
pehan	पहन	पहन
pahantaa	पहनता	पहनता
pahnata	पहनता	पहनता
pehnate	पहनता	पहनते
pahanate	पहनते	पहनते
pahante	पहनते	पहनते
pehnate	पहनते	पहनते
pahnaakar	पहनाकर	पहनाकार
pahnakar	पहनाकर	पहनकर
pehnakar	पहनाकर	पहनका
pahnaati	पहनाती	पहनती
pahnati	पहनाती	पहनती
pehnati	पहनाती	पहनाती
pahani	पहनी	पहनी
pahni	पहनी	पहनी
pehni	पहनी	पेनेड
pahno	पहनो	पहनो
pehno	पहनो	पहनो
pahla	पहला	पहला
pahlaa	पहला	पहला
pehla	पहला	पहताई
paheliyaan	पहेलियां	पहलियां
paheliyan	पहेलियां	पहलियां
paheliyon	पहेलियों	पहितियों
pide	पाइड	पीड़े
pied	पाइड	पीड़
pythagoras	पाइथागोरस	प्लामद्रों
pythogaras	पाइथागोरस	प्लाउंडल
paakhandi	पाखंडी	पढ़ना
pakhandi	पाखंडी	पढ़ना
paathshaalaayein	पाठशालाएं	पाथशिलाएं
pathshalayein	पाठशालाएं	पहासिस्थिया
pathshalayen	पाठशालाएं	पहासित्महा
paathyakram	पाठ्यक्रम	पात्साखी
pathyakram	पाठ्यक्रम	पत्यात्री
pathykram	पाठ्यक्रम	पत्यात्री
paathyakramon	पाठ्यक्रमों	पात्स्क्रापूर्ण
pathyakramon	पाठ्यक्रमों	पत्यावक्षी
pathykramon	पाठ्यक्रमों	पत्यावृत्त
population	पापुलेशन	पाउपपुरोस्कों
pailot	पायलट	पैसल
pilot	पायलट	पिस्तू
pailoton	पायलटों	पैस्टियों
piloton	पायलटों	पिस्तूकों
paarampariktaa	पारंपरिकता	पारंत्रिता
paramparikata	पारंपरिकता	परमाकारिता
paramparikta	पारंपरिकता	परमाकार्त्रि
parnel	पार्नेल	परब्र
parnell	पार्नेल	परिप्रेस
parleron	पार्लरों	पर्लिक
parloron	पार्लरों	पर्लों
parlouron	पार्लरों	पर्लूकीय
paarshad	पार्षद	पार्ड्स
parshad	पार्षद	पर्साद
paarshadon	पार्षदों	पार्श्वों
parshadon	पार्षदों	पर्साद्रों
parshdon	पार्षदों	पर्स्कड़ों
policy	पालिसी	पोलियों
pinta	पिंटा	पिंटा
pintaa	पिंटा	पिंटा
piega	पिएगा	पियाग
piyegaa	पिएगा	पियागी
pic	पिक	पिक
pick	पिक	पिक
pik	पिक	पिक
piki	पिकी	पिकी
piky	पिकी	पिक्य
picture	पिक्चर	पिक्टरी
pigmentation	पिगमेंटेशन	पिंगिक्षताता
pigs	पिग्स	पिम्य
pichde	पिछड़े	पिछे
pichhade	पिछड़े	पिछते
pijja	पिज्जा	पिजाज़
pizza	पिज्जा	पिजाज़
pitaamaha	पितामह	पिताजाव
pitamah	पितामह	पिताजाव
pipra	पिपरा	पिपर
pipraa	पिपरा	पिपर
pipli	पिपली	पाइब्ल
pearson	पियरसन	पीर्सों
pierson	पियरसन	पिरियों
peary	पियरी	पीरा
piyari	पियरी	पियारी
pisaai	पिसाई	पिसाई
pisai	पिसाई	पिसाई
pihaani	पिहानी	पिहानी
pihani	पिहानी	पिहानी
pib	पीआईबी	पिन
pr	पीआर	प्रीएच
pml	पीएमएल	प्मेम
pmo	पीएमओ	प्मोग
pmch	पीएमसीएच	प्मेड
psv	पीएसवी	प्रोव
peaking	पीकिंग	पीकनी
picking	पीकिंग	पिकिंग
peetne	पीटने	पीतें
pitne	पीटने	पिताब
pedia	पीडिया	पेडिया
pidiya	पीडिया	पीड़ायी
pidiyaa	पीडिया	पीड़ायाई
peelepan	पीलेपन	पीलापी
pilepan	पीलेपन	पिलापी
pv	पीवी	प्विड
pisa	पीसा	पिसा
putla	पुतला	पुतासी
putlaa	पुतला	पुतायल
putaliyaan	पुतलियां	पुतायुकाम
putliyan	पुतलियां	पुतलोगिक
putaliyon	पुतलियों	पुतासियों
putliyon	पुतलियों	पुतलों
putali	पुतली	पुलल
putli	पुतली	पुलती
putale	पुतले	पुताली
putle	पुतले	पुतली
putin	पुतिन	पुती
putul	पुतुल	पुस्ली
punargathan	पुनर्गठन	पुनर्भाताओं
puna	पुना	पूना
puraane	पुराने	पुराने
purane	पुराने	पुराने
puru	पुरू	पूर्व
purjon	पुर्जों	पुर्तों
purzon	पुर्जों	पुर्तों
pulam	पुलम	पुलाम
pushkin	पुश्किन	पुषुकों
pushkarana	पुष्करणा	पुष्कारण
pushkarna	पुष्करणा	पुष्कारण
pushkarnaa	पुष्करणा	पुष्कारण
pushp	पुष्प	पूर्वम
pushpa	पुष्प	पुष्प
pushpa	पुष्पा	पुष्प
pushpaa	पुष्पा	पुष्प
pushpit	पुष्पित	पुष्प्रम
pushpon	पुष्पों	पूर्णतों
poonjikaran	पूंजीकरण	पूंजिकार
punjikaran	पूंजीकरण	पुनर्जनीय
poojaapaath	पूजापाठ	पूज्वता
poojapath	पूजापाठ	पूज्वत
pujapath	पूजापाठ	पुजात्र
pooranpur	पूरनपुर	पूर्णियां
puranpur	पूरनपुर	पुरानी
purvaabhaas	पूर्वाभास	पुरावाहल
purvaabhas	पूर्वाभास	पुरावाहल
purvabhaas	पूर्वाभास	पुरावाभ्यास
purvabhas	पूर्वाभास	पुर्वावम
pendulam	पेंडुलम	पेंडिस
pendulum	पेंडुलम	पेंडीस
peg	पेग	पेग
pages	पेजेज	पागी
pajej	पेजेज	पज़ेज
pace	पेस	पैक
pes	पेस	पेस
pastry	पेस्ट्री	पस्त्र
pangolin	पैंगोलिन	पंजियों
pengolin	पैंगोलिन	पेंगिसिक
packard	पैकर्ड	पकड़कर
package	पैकेज	पक्कागे
packageon	पैकेजों	पकियां
packagon	पैकेजों	पक्यों
packajon	पैकेजों	पक्यमन
paim	पैम	पैस
pam	पैम	पाम
paratrooper	पैराट्रूपर	पराकुली
peratrupers	पैराट्रूपर	पेरात्मिक
paranormal	पैरानॉर्मल	परामालु
peranormal	पैरानॉर्मल	पेरानुमाल
paraffin	पैराफिन	परास्टार
parafin	पैराफिन	परासने
perafin	पैराफिन	पेरासन
parabola	पैराबोला	पराबाली
perabola	पैराबोला	पर्माबारी
polimer	पॉलिमर	पॉल्प्स
polymer	पॉलिमर	पॉलर्स
polishing	पॉलिशिंग	पॉलिंगिस
pokar	पोकर	पोकरा
poker	पोकर	पोकरी
polish	पोलिश	पोल्श
poshit	पोषित	पश्चिस
posta	पोस्ता	पोस्ता
pau	पौ	पौऊ
pyade	प्यादे	प्षाय
prakriya	प्रक्रिया	प्रकायिकार
prakshepak	प्रक्षेपक	प्रक्षेक
pratigya	प्रतिज्ञा	प्रतियान
prtigyaa	प्रतिज्ञा	प्रत्याग्रय
pratibhutiyan	प्रतिभूतियां	प्रतिभागिताएं
pratiyon	प्रतियों	प्रतियों
prativaad	प्रतिवाद	प्रतिद्वा
prativad	प्रतिवाद	प्रतिद्वार
prativadi	प्रतिवादी	प्रतिद्वार
pratishat	प्रतिशत	प्रतिक्षत
praneet	प्रनीत	प्रणित्पर
pranit	प्रनीत	प्रणित
prapaat	प्रपात	प्रणात
prapat	प्रपात	प्रण
prapaaton	प्रपातों	प्रणात्नों
prapaton	प्रपातों	प्रपतों
prabodhini	प्रबोधिनी	प्रबुद्धिनों
prayaasrat	प्रयासरत	प्रायास्त
prayasarat	प्रयासरत	प्रयायता
pradarshan	प्रर्दशन	प्रदार्शन
prardashan	प्रर्दशन	प्रस्कार्धा
pravati	प्रवत्ति	प्रवाल
pravatti	प्रवत्ति	प्रतित्व
prashaasanik	प्रशासनिक	प्रशासनों
prashasanik	प्रशासनिक	प्रशासियों
prashasnik	प्रशासनिक	प्रशासिक
prashaasanon	प्रशासनों	प्रशासनों
prashansanon	प्रशासनों	प्रशानसंग
prashasanon	प्रशासनों	प्रशासनों
prashikshu	प्रशिक्षु	प्रशिक्षार्थ
prastaavon	प्रस्तावों	प्रस्तावों
prastavon	प्रस्तावों	प्रस्तावों
prahlaad	प्रहलाद	प्राह्वत
prahlad	प्रहलाद	प्राह्वत
prahasan	प्रहसन	प्रायान्स
prahsan	प्रहसन	प्रायांश
prahaarak	प्रहारक	प्रहारक
praharak	प्रहारक	प्रहारक
prahad	प्रह्लाद	प्राह
prahlad	प्रह्लाद	प्राह्वत
privacy	प्राइवेसी	प्रविक
praakkathan	प्राक्कथन	प्रकाशक
prakkathan	प्राक्कथन	प्रकाशक
praan	प्राण	प्रां
pran	प्राण	प्रण
pranon	प्राणों	प्रणों
prathamik	प्राथमिक	प्रताभोजिक
prathmik	प्राथमिक	प्रतापूर्त
praathmikata	प्राथमिकता	प्रताजित्रों
prathmikta	प्राथमिकता	प्रत्यापूठता
prathmiki	प्राथमिकी	प्रतिभूत
pradhyapakon	प्राध्यापकों	प्रधार्ण
prapt	प्राप्त	प्रण
prapta	प्राप्त	प्रण्टा
prapti	प्राप्ती	प्रतिन
praroop	प्रारूप	प्रोक्यूर
prarup	प्रारूप	प्रौने
priyamani	प्रियामणि	प्रियामिया
proof	प्रूफ	प्रोस
pruf	प्रूफ	प्रोज
prekshakon	प्रेक्षकों	प्रिक्षकों
prem	प्रेम	प्रेम
premlata	प्रेमलता	प्रेमास्तर
prema	प्रेमा	प्रेमा
premi	प्रेमी	प्रेम
profit	प्रॉफिट	प्रोत्सिक
processing	प्रॉसेसिंग	प्रोजेस्की
programers	प्रोग्रामर्स	प्रोग्नियल्स
programmers	प्रोग्रामर्स	प्रोग्नियलम
programs	प्रोग्रामर्स	प्रोग्साल
proto	प्रोटो	प्रोसों
propellant	प्रोपेलेंट	प्रोप्रामेंस
propellent	प्रोपेलेंट	प्रॉब्रिट्स
praudh	प्रौढ	प्रौढ़
proud	प्रौढ	प्रोडि
plan	प्लेन	प्लान
plane	प्लेन	प्लेंस
fund	फंड	फूंड
funda	फंडा	फूंदा
funding	फंडिंग	फुंडों
fandon	फंदों	फंदों
fagua	फगुआ	फज्ञा
fatane	फटने	फाटने
phatane	फटने	फटाने
phatne	फटने	फटने
fadfadata	फड़फड़ाता	फद्दाताता
phadphadata	फड़फड़ाता	फाद्धता
fatehgadh	फतेहगढ़	फत्यभूड़
fatehgarh	फतेहगढ़	फत्यभूर
fabti	फब्ती	फबती
phabti	फब्ती	फाबित
farse	फरसे	फर्स
pharase	फरसे	फरास
pharse	फरसे	फर्स
farheen	फरहीन	फरहें
farhin	फरहीन	फर्हों
farth	फर्थ	फर्ड्स
ferth	फर्थ	फेर्ड्स
pharth	फर्थ	फर्द्स
farmion	फर्मिऑन	फर्मिन
fermion	फर्मिऑन	फर्मिन
firmian	फर्मिऑन	फिरमानियों
farookhabad	फर्रुखाबाद	फरोच्छार
farrukhabad	फर्रुखाबाद	फरुचार्भ
farukhabad	फर्रुखाबाद	फरोधार्चा
farookhnagar	फर्रूखनगर	फरुकवारों
farrukhnagar	फर्रूखनगर	फरुकवारी
farukhnagar	फर्रूखनगर	फरुड़कारी
falata	फलता	फलता
falta	फलता	फलता
phalata	फलता	फलता
falne	फलने	फलने
phalne	फलने	फलने
falitarth	फलितार्थ	फैल्ट्रेड्स
phalitartha	फलितार्थ	फल्थर्चास
falibhoot	फलीभूत	फल्लेंगे
falibhut	फलीभूत	फल्लेन
phalibhoot	फलीभूत	फल्बिंग्स
favvara	फव्वारा	फववार
fawaara	फव्वारा	फवारा
favvare	फव्वारे	फववर
fawaare	फव्वारे	फवारे
favvaron	फव्वारों	फववारों
fawaaron	फव्वारों	फवारों
faisala	फ़ैसला	फैसला
faisla	फ़ैसला	फैसल
follow	फ़ॉलो	फॉल्सव
faansi	फांसी	फांसी
fansi	फांसी	फांसी
fatama	फातमा	फाफमा
fatma	फातमा	फात्मा
faaf	फाफ	फाफ
phaaph	फाफ	फाप
farsi	फारसी	फर्सिया
forcee	फारसी	फोरी
farm	फार्म	फर्म
form	फार्म	फोरम
farmic	फार्मिक	फर्मिन
formic	फार्मिक	फोरमिन
formulae	फार्मूले	फोरमिलर
formule	फार्मूले	फोरमिल
formuley	फार्मूले	फोरमिल
pharmacy	फार्मेसी	फर्मानिया
pharma	फार्मों	फरमा
pharmon	फार्मों	फरोमों
farms	फार्म्स	फर्म्स
finger	फिंगर	फिंगर
fikra	फिक्र	फिकारा
physician	फिजिशियन	फिस्कियां
firti	फिरती	फिरसे
fisla	फिसला	फिसल
fislaa	फिसला	फिसला
feeder	फीडर	फीडेर
fulaaye	फुलाए	फुलाए
fulae	फुलाए	फुलाए
fulay	फुलाए	फुलाया
furti	फूर्ति	फ्रूक्स
phurti	फूर्ति	फूटरी
fus	फूस	फूस
phoos	फूस	फूस
phus	फूस	फूस
feka	फेका	फेका
fefada	फेफड़ा	फ्वाडाता
fefda	फेफड़ा	फेडता
facial	फेशियल	फैकल
fact	फैक्ट	फैक्स
federal	फैडरल	फेडरेस
failkar	फैलकर	फैलकर
failaaiye	फैलाइए	फैलाइया
failaea	फैलाइए	फैलाए
failaiya	फैलाइए	फैलायाई
failaiye	फैलाइए	फैलाये
failegi	फैलेगी	फैली
font	फॉन्ट	फॉक्स
fogat	फोगाट	फोग्त
phogat	फोगाट	फोग्ता
fod	फोड़	फोड
phod	फोड़	फोड
foda	फोड़ा	फाड़ा
fodaa	फोड़ा	फोड़ा
phoda	फोड़ा	फोड़ा
fode	फोड़े	फोड़े
phode	फोड़े	फोडे
fodo	फोड़ों	फोडो
fodon	फोड़ों	फोडों
phodo	फोड़ों	फोडो
fortis	फोर्टिस	फोर्सिस
fusion	फ्यूजन	फूसिंग
fuji	फ्यूजी	फूसे
fyuji	फ्यूजी	फ्यूजी
francisca	फ्रांसिस्का	फ्रांसपुर
franciska	फ्रांसिस्का	फ्रांसपुर्क
fransiska	फ्रांसिस्का	फ्रांसपाल्प
francisco	फ्रांसिस्को	फ्रांसिंग
francisko	फ्रांसिस्को	फ्रांसिंग
fransisko	फ्रांसिस्को	फ्रांस्सिक
fringe	फ्रिंज	फ्रेंस
friendship	फ्रेंडशिप	फ्रेंसिक्स
frost	फ्रॉस्ट	फ्रोस्ट
flin	फ्लिन	फ्लीन
flynn	फ्लिन	फ्लांस
flesh	फ्लेश	फ्लेश
bang	बंग	बांग
bung	बंग	बुन
bangbandhu	बंगबंधु	बंगढ़ी
bangbhang	बंगभंग	बंगड़ी
bangash	बंगश	बंगड़ी
bangsh	बंगश	बंगो
bantane	बंटने	बंटने
bantne	बंटने	बंटकी
bandhati	बंधती	बंदभात
bandhti	बंधती	बंदीत
bandhan	बंधान	बंदाद
bandhuon	बंधुओं	बंदुकी
bamba	बंबा	बामने
mumba	बंबा	मूम्या
bakaayon	बकायों	बकायाओं
bakayon	बकायों	बकायों
bakaul	बकौल	बकलू
bakoul	बकौल	बैक्सिया
baksa	बक्सा	बक्सा
baksi	बक्सी	बक्सी
bakse	बक्से	बक्जे
bakhshane	बख्शने	बक्षभा
bakhshne	बख्शने	बक्षभ
bagad	बगड़	बगद
bagd	बगड़	बागड़
bageechi	बगीची	बाघिक
bagichi	बगीची	बागिंही
bachat	बचत	बैक्ट
bachati	बचती	बच्चती
bachti	बचती	बैचती
bajana	बजना	बजाना
bajrangi	बजरंगी	बजरीय
bajaj	बजाज	बजात
batalvi	बटालवी	बतलवी
badhachadhakar	बढ़ाचढ़ाकर	बढ़काएं
badata	बढ़ाता	बदाता
badhaataa	बढ़ाता	बढ़ता
badhata	बढ़ाता	बढ़ता
badhaati	बढ़ाती	बढ़ती
badhati	बढ़ाती	बढ़ती
badhayi	बढ़ायी	बढ़ायी
badhav	बढ़ाव	बढ़ा
badhotari	बढ़ोतरी	बाधुक्ष
badhotri	बढ़ोतरी	बाधुक्ष
batlaae	बतलाए	बतलाई
batlaaye	बतलाए	बतलाए
batlae	बतलाए	बतलाई
batlaye	बतलाए	बतलाए
batlaakar	बतलाकर	बतलाकर
batlakar	बतलाकर	बतलाकर
badlapur	बदलापुर	बदलपूर्ण
badali	बदली	बदली
badli	बदली	बाड़ील
badam	बदाम	बद्म
banva	बनवा	बांवा
banvaa	बनवा	बांदाव
banaam	बनाम	बनाम
banam	बनाम	बनास
bnaam	बनाम	बनास
baniya	बनिया	बनायी
banu	बनू	बनु
barpaayaa	बरपाया	बर्पा
barpaya	बरपाया	बर्पा
barsa	बरसा	बरसा
barsaata	बरसाता	बरसाता
barsaataa	बरसाता	बरसाता
barsata	बरसाता	बरसाता
barhad	बरहद	बरहद
baraat	बरात	बरात
barat	बरात	बर्त
braat	बरात	ब्रात
baraamad	बरामद	बरांदाज
baramad	बरामद	बर्दम
bramad	बरामद	ब्रामद
baramade	बरामदे	बर्बादास
baramde	बरामदे	बर्बद
bare	बरे	बर्क
birth	बर्थ	बीर्ड्स
baljeet	बलजीत	बल्जेत
baljit	बलजीत	बल्सिंत
ballabh	बल्लभ	बल्हाबल
balla	बल्ला	बलाल
balli	बल्ली	बल्ली
basava	बसावा	बसवा
bastiyon	बस्तियों	बस्कित
bahroopiya	बहरूपिया	बहुरंगीय
bahrupiya	बहरूपिया	बहरोगिकी
bahamaas	बहामास	बहमास
bahamas	बहामास	बहमास
bahaav	बहाव	बहाव
bahav	बहाव	बहाड़ी
bhav	बहाव	भवा
bahavalpur	बहावलपुर	बहावलूप
bahawalpur	बहावलपुर	बहावलूप
bahuchara	बहुचरा	बहुद्वार
banthia	बांठिया	बंदाली
banthiya	बांठिया	बंदाजी
bandhate	बांधते	बंधाते
bandhte	बांधते	बंदभ
banbi	बांबी	बनी
bombi	बांबी	बोमी
bounceron	बाउंसरों	बौनिक
bowling	बाउलिंग	बोलिंग
baku	बाकू	बको
bakuu	बाकू	बकोई
baag	बाग	भाग
bag	बाग	बाग
bagh	बाग	बाग
bagabani	बागबानी	बगाइका
bagbani	बागबानी	बगने
bagali	बागली	बगली
bagli	बागली	बगली
baagiyon	बागियों	भागियों
bagiyon	बागियों	बागियों
baago	बागो	भागो
bago	बागो	बागो
baji	बाज़ी	बजी
bazi	बाज़ी	बजी
bajaru	बाजारू	बजारी
bazaru	बाजारू	बजारी
bajuon	बाजुओं	बजों
badh	बाध	बढ़
badha	बाधा	बढ़ा
baadhaaon	बाधाओं	बाधाओं
baadhaon	बाधाओं	बाधाओं
badhaaon	बाधाओं	बढ़ाओं
badhaon	बाधाओं	बढ़ों
baadhit	बाधित	बढ़ती
badhit	बाधित	बढ़ती
baani	बानी	भानी
bani	बानी	बनी
baapa	बापा	बापा
baapaa	बापा	बापा
bapa	बापा	बापा
bapaa	बापा	बापा
baabat	बाबत	बाबत
babat	बाबत	बाबत
babt	बाबत	बाबत
bayern	बायर्न	बायरें
byrun	बायर्न	ब्रून
barah	बारह	बरह
baarahamaasee	बारहमासी	बारहमल
barahamasi	बारहमासी	बर्जवाल
barahmasi	बारहमासी	बर्जवासी
barahsinga	बारहसिंगा	बर्शियां
barasingha	बारहसिंगा	बर्विंग
bala	बाला	बला
baalti	बाल्टी	बालित
balti	बाल्टी	बल्टी
balty	बाल्टी	बल्ट
baldvin	बाल्डविन	बल्दें
baldwin	बाल्डविन	बल्दें
bavaji	बावजी	बवासी
bavji	बावजी	बावसी
baawaraa	बावरा	बावरा
bavra	बावरा	बवर
bawara	बावरा	बवारा
baahulya	बाहुल्य	बहुत्याय
bahuly	बाहुल्य	बहुजी
bahulya	बाहुल्य	बहुजाई
box	बाॅक्स	बोक्सी
bikherati	बिखेरती	बिक्सरी
bikherti	बिखेरती	बिखर्ती
biggest	बिगेस्ट	बिजिस
bichhua	बिछुआ	बिछुआ
bichhuaa	बिछुआ	बिछाये
biji	बिजी	बिजी
busy	बिजी	ब्यूस
buzy	बिजी	बुस
bipin	बिपिन	बिप्पी
bilae	बिलाई	बिलाई
bilai	बिलाई	बिलाई
billa	बिल्ला	बिलाल
billaa	बिल्ला	बिलाल
bilhaur	बिल्हौर	बालवर्च
bisva	बिस्वा	बिसवा
biswa	बिस्वा	बिसवा
bag	बीएजी	बाग
bikaner	बीकानेर	बिकारें
bikaneri	बीकानेरी	बिकारीन
bk	बीके	बे
beejak	बीजक	बेज़ाने
bijak	बीजक	बिजान
beef	बीफ	बेत
beem	बीम	बीज
bim	बीम	बीमी
beemon	बीमों	बीमों
bimon	बीमों	बोमियों
beerganj	बीरगंज	बेरमंग
birganj	बीरगंज	बिजपुर
beesavaan	बीसवां	बीसवान्य
bisavan	बीसवां	बिसावान
bisawan	बीसवां	बिस्वान्द
beast	बीस्ट	बेसत
budvig	बुडविग	बुद्वी
budwig	बुडविग	ब्वोवर
bull	बुल	बलल
bulaao	बुलाओ	बुलाया
bulao	बुलाओ	बुला
bule	बुले	बले
bulletin	बुलेटिन	बललिक्स
brijesh	बृजेश	ब्रिस्ट्र
benvar	बेंवर	बेंदरी
benwar	बेंवर	बेंदरी
beaulad	बेऔलाद	बिदूला
bekaaboo	बेकाबू	बेकागी
bekabu	बेकाबू	बेकबू
bechakar	बेचकर	बेकहार
bechkar	बेचकर	बेकेडा
bechate	बेचते	बेचते
bechte	बेचते	बेक्ते
bediyan	बेड़ियां	बेडियां
bethanal	बेथनल	बेथनाल
bethnal	बेथनल	बेथनेस
benis	बेनिस	बेंग्स
belacha	बेलचा	बेलहाय
belcha	बेलचा	बेल्ड
belinda	बेलिंडा	बेल्डिंग
bevkufana	बेवकूफाना	बेल्ड्रेयाना
bewakoofaanaa	बेवकूफाना	बेवाक्त्रों
bewkufana	बेवकूफाना	बेल्ड्रेयाना
besahaaraa	बेसहारा	बेसवार
besahara	बेसहारा	बेसवार
basin	बेसिन	बसीन
besin	बेसिन	बेसिंग
basil	बेसिल	बसील
besil	बेसिल	बेसिस
bandage	बैंडेज	बंदागी
bandej	बैंडेज	बंदेज
baithantey	बैठते	बैठाकाश
baithate	बैठते	बैठकाल
baitool	बैतूल	बैसली
baitul	बैतूल	बैसल
betul	बैतूल	बेटूस
baini	बैनी	बैनी
beni	बैनी	बेनी
bairakpur	बैरकपुर	बैरकीपूर्ण
barrackpore	बैरकपुर	बरकरिक
baila	बैला	बैला
bella	बैला	बेलल
ballistic	बैलिस्टिक	बल्लिस्तानी
bells	बैल्स	बेल्स
bostan	बॉस्टन	बोस्तन
bosten	बॉस्टन	बोस्तें
boston	बॉस्टन	बोस्तों
bokaro	बोकारो	बोकरों
bodara	बोदरा	बोड़ावा
bodra	बोदरा	बोड़ार
bodraa	बोदरा	बोड़ाव
bona	बोना	बोना
borkar	बोरकर	बोरकार
borivali	बोरीवली	बोर्शियाई
boriwali	बोरीवली	बोर्शियाई
born	बोर्न	बोर्न
bolane	बोलने	बोलने
boliae	बोलिए	बोली
boliy	बोलिए	बोली
boliye	बोलिए	बोली
bosaan	बोसान	बोसन
bosan	बोसान	बोसन
bauni	बौनी	बौनी
bouni	बौनी	बौनी
byaawa	ब्यावर	ब्यावा
byavar	ब्यावर	ब्यावर
brajesh	ब्रजेश	ब्रेस्ट
brijesh	ब्रजेश	ब्रिस्ट्र
brahmalin	ब्रह्मलीन	ब्रह्मानिमार
brahmleen	ब्रह्मलीन	ब्रह्मिति
brahmlin	ब्रह्मलीन	ब्रह्मिति
bravo	ब्रावो	ब्रोव
brigatn	ब्रिगटन	ब्रायन
brighton	ब्रिगटन	ब्रायोनिक्स
brigton	ब्रिगटन	ब्रायोजिक
brigadier	ब्रिगेडियर	ब्रिग्यूच
britain	ब्रिटेन	ब्रिक्सिना
breed	ब्रीद	ब्रेड
brock	ब्रोक	ब्रूक
brok	ब्रोक	ब्रूक
broke	ब्रोक	ब्रूक
brocken	ब्रोकन	ब्रुकिक
broken	ब्रोकन	ब्रुकन
blosam	ब्लॉसम	ब्लॉस्म
blossom	ब्लॉसम	ब्लॉस्स
bhagaane	भगाने	भागने
bhagane	भगाने	भागने
bhadakaaya	भड़काया	भादकाया
bhadakaya	भड़काया	भादकाया
bhadkaayaa	भड़काया	भादकाया
bhadkaya	भड़काया	भादकाय
bharakaaya	भड़काया	भरकाया
bharakaya	भड़काया	भरकाया
bhabhoot	भभूत	भाभूत
bhabhut	भभूत	भाभूत
bhay	भय	भाय
bhaya	भय	भाय
bhayo	भयो	भाओ
bharatanatyam	भरतनाट्यम्	भर्तांत्सान
bharatnatyam	भरतनाट्यम्	भर्तांत्सन
bhartnatyam	भरतनाट्यम्	भर्तांत्मा
bharate	भरते	भर्ते
bharte	भरते	भर्ते
bharani	भरनी	भराने
bharni	भरनी	भरपूर
bharane	भरने	भरने
bharne	भरने	भरपार
bhara	भरा	भरा
bhavishya	भविष्य	भवासिया
bhaate	भाते	भाते
bhate	भाते	भटाई
bhanu	भानू	भांग
bhabar	भाबर	भाबर
bhareeye	भारीय	भराई
bhariy	भारीय	भरीय
bhavanaon	भावनाओं	भवानों
bhavnaon	भावनाओं	भावनों
bhaskar	भास्कर	भस्कार
bheed	भीड़	भीड़
bheera	भीरा	भीरा
bhira	भीरा	भिरा
bheesham	भीष्म	भिष्म
bhisham	भीष्म	भिष्म
bhishm	भीष्म	भिष्म
bhugat	भुगत	भूमन
bhugata	भुगता	भूमना
bhugta	भुगता	भूमन
bhutto	भुट्टो	भूतत
bhumi	भुमि	भूमी
bhurbhura	भुरभुरा	भूरभूर्ण
bhookh	भूख	भूकड़ी
bhukh	भूख	भूका
bhookhi	भूखी	भूचिक
bhukhi	भूखी	भूहिय
bhoogol	भूगोल	भूमी
bhugol	भूगोल	भूमिय
bhootal	भूतल	भूताल
bhutal	भूतल	भूताल
bhoopsingh	भूपसिंह	भूपर्थ
bhupsingh	भूपसिंह	भूमिपूर्ण
bhumi	भूमी	भूमी
bhumika	भूमी	भूमिका
bhulata	भूलता	भूतायत
bhulataa	भूलता	भूतायते
bhulta	भूलता	भूताती
bhula	भूला	भूला
bhulaa	भूला	भूला
bhooli	भूली	भूली
bhuli	भूली	भूली
bhulo	भूलो	भूला
bhulon	भूलों	भूलकों
bhusi	भूसी	भूसी
bhooswaami	भूस्वामी	भूसवाली
bhusvami	भूस्वामी	भूसवासी
bhuswami	भूस्वामी	भूसवासी
bhengapan	भेंगापन	भेंजायां
bhairavnath	भैरवनाथ	भारीपाठ
bhairo	भैरो	भारू
bhogatey	भोगते	भोगते
bhogte	भोगते	भोजने
bhola	भोला	भोला
bholi	भोली	भोली
bholu	भोलू	भोली
bhaunho	भौंहों	भौनी
bhaunhon	भौंहों	भौनिक
bhoonhon	भौंहों	भूनदों
bhraant	भ्रांत	भ्रातन
bhrant	भ्रांत	भ्रमण
brant	भ्रांत	ब्रांत
bhraanti	भ्रांति	भ्रात्पी
bhranti	भ्रांति	भ्रमण
branti	भ्रांति	ब्रेंस्क
bhraantiyan	भ्रांतियां	भ्रार्मण
bhrantiyan	भ्रांतियां	भ्रमैनिक
bhraantiyon	भ्रांतियों	भ्रार्मनों
bhrantiyon	भ्रांतियों	भ्रमोनिक
mangesh	मंगेश	मंगश
manch	मंच	मन्न
manchit	मंचित	मन्नित्व
mancheeye	मंचीय	मनहेये
manchiy	मंचीय	मनीदी
manchiya	मंचीय	मनिहाय
manchon	मंचों	मनोंदु
manjil	मंजिल	मंजील
manzil	मंजिल	मंजील
manjila	मंजिला	मंगलती
manzila	मंजिला	मंगलती
manjilein	मंजिलें	मंजितियु
manjilen	मंजिलें	मंजिति
manzilein	मंजिलें	मंजितियु
manto	मंटो	मनतो
mantriyon	मंत्रियों	मंतूरों
makrani	मकरानी	मकरने
maksad	मक्सद	मक्साद
makhdumpur	मखदुमपुर	मक्त्रोहीद
machaaye	मचाए	मछाये
machae	मचाए	मछाई
machaye	मचाए	मछाये
machaanon	मचानों	मच्नाओं
machanno	मचानों	मैन्नों
machano	मचानों	मचना
machanon	मचानों	मचनों
madaura	मढ़ौरा	मदरोय
madhuara	मढ़ौरा	मधुरा
madhura	मढ़ौरा	मधुर्ग
manipal	मणिपाल	मनिला
matpatron	मतपत्रों	मतप्तियों
matthe	मत्थे	मत्थी
matsyavatar	मत्स्यावतार	मतस्क्षर
matsyavtar	मत्स्यावतार	मतस्क्षीय
masyendranath	मत्स्येंद्रनाथ	मस्तेबंध
matsyendranath	मत्स्येंद्रनाथ	मतम्चार्थों
madhupur	मधुपुर	मधुर्ग
manmarji	मनमर्जी	मंजूरता
manae	मनाए	माने
manaye	मनाए	माने
mnaey	मनाए	मनाई
mam	मम	माम
mum	मम	मूम
maryokar	मयोर्का	मर्किया
mayorka	मयोर्का	मौजायों
mayorkaa	मयोर्का	मौजायां
mardaani	मरदानी	मरदूना
mardani	मरदानी	मरदूना
marmar	मरमर	मर्मा
murmur	मरमर	मूर्ब्स
maratha	मराठा	मर्था
marathi	मराठी	मार्शे
marji	मर्जी	मर्सी
mardanagi	मर्दानगी	मरदूना
mardangi	मर्दानगी	मरदूना
mardo	मर्दों	मारदो
mardon	मर्दों	मरदों
maryaadaa	मर्यादा	मर्याद
maryada	मर्यादा	मर्याद
maryaadaaon	मर्यादाओं	मार्यवाया
maryadaon	मर्यादाओं	मर्यादाओं
malaga	मलागा	मलागा
malaar	मलार	मलार
malar	मलार	मलार
mashrak	मशरक	मार्कश
masaaledaar	मसालेदार	मस्तवरी
masaledaar	मसालेदार	मस्तेहार
masaledar	मसालेदार	मस्तेहार
masoor	मसूर	मौसर
masur	मसूर	मासुर
masse	मस्से	मस्ते
mahakane	महकने	महकाकी
mahakne	महकने	महकांक
mahkane	महकने	महकांक
mehkane	महकने	महकाने
mahalon	महलों	महुओतो
mahlon	महलों	महोतिम
mahagranth	महाग्रंथ	महामंद्री
mhagranth	महाग्रंथ	महामंद्र
mahajan	महाजन	महज्ञा
mhajan	महाजन	महामा
mahathir	महाथिर	महाक्षे
mhathir	महाथिर	महत्वर
mahanatam	महानतम	महानतम
mahantam	महानतम	महानतम
mhantam	महानतम	महंतम
mahanideshak	महानिदेशक	महांचक्षी
mahanirdeshak	महानिदेशक	महाप्रदर्शिक
mhanideshak	महानिदेशक	महंचितों
mahapauron	महापौरों	महापुरों
mhapauron	महापौरों	महापूर्ण
mahapran	महाप्राण	महापरक
mhapran	महाप्राण	महापूर्ण
mahamantr	महामंत्र	महम्नता
mahamantra	महामंत्र	महामंत्र
mhamantra	महामंत्र	महामंत्र
maharaja	महाराजा	महाराज
mahavigyan	महाविज्ञान	महाद्यीयिक
mhavidyan	महाविज्ञान	महाद्वीयों
mahavidya	महाविद्या	महाद्विया
mhavidya	महाविद्या	महाद्वीय
mahavishnu	महाविष्णु	महादिषीय
mahasingh	महासिंह	महाशिंद
mahasinh	महासिंह	महसीं
mahipal	महिपाल	महिप्ला
mahin	महीन	महिन
mahinon	महीनों	महिनों
maang	मांग	मान
mang	मांग	मंग
mangani	मांगनी	मंगानी
mangni	मांगनी	मंगी
maanga	मांगा	माना
manga	मांगा	मागन
maangi	मांगी	मानी
mangi	मांगी	मैंगी
maange	मांगे	माने
mange	मांगे	मंगे
mango	मांगो	मनोग
maori	माओरी	मौरी
maajin	माजिन	माजिक
majin	माजिन	मजीन
mathe	माथे	महती
mathey	माथे	महाएस
maap	माप	माप
map	माप	माप
mop	माप	मोप
mamooli	मामूली	मामूली
mamuli	मामूली	मामूली
mame	मामे	मेम
maarvaad	मारवाड़	मारदाव
marvad	मारवाड़	मर्वा
marwar	मारवाड़	मरवार
maariya	मारिया	मारिया
mariya	मारिया	मरीय
maariyo	मारियो	मारीय
mario	मारियो	मर्यू
mariyo	मारियो	मर्य
martha	मार्था	मर्दता
maalish	मालिश	मालिष
malish	मालिश	मैल्स
mave	मावे	मावे
mavey	मावे	मवीय
maas	मास	मास
mas	मास	मस
mass	मास	मस्स
maason	मासों	मातों
mason	मासों	मैसों
mitaao	मिटाओ	मिलाओ
mitao	मिटाओ	मिलाओ
mithaai	मिठाई	मिलाहा
mithai	मिठाई	मिलाह
media	मिडिया	मेडिया
mithila	मिथिला	मिल्ले
mithilanchal	मिथिलांचल	मिलेशियात्च
mithya	मिथ्या	मिथाया
mimicry	मिमिक्री	मिंसरी
milkiyat	मिल्कियत	मिलाकियत
misha	मिशा	मिशा
mungeri	मुंगेरी	मुग्नेरी
mundva	मुंडवा	मुंडाव
mundwa	मुंडवा	मुंडाव
munshiganj	मुंशीगंज	मुगल्डित
mukarte	मुकरते	मुक्तरा
mukartey	मुकरते	मुकर्तार
mukhopadhyaya	मुखोपाध्याय	मुकवादीवाद
mukhyopadhyaay	मुखोपाध्याय	मुकवादीवाद
mukhyamantri	मुख्यमंत्री	मुक्सन्यताएं
munaf	मुनाफ	मुन्ता
munafa	मुनाफा	मुनाता
munnu	मुन्नू	मुन्नू
mufalisi	मुफलिसी	म्लालियल
muflisi	मुफलिसी	म्यूलिस
mubarakpur	मुबारकपुर	मूर्बनिकार
mubarkpur	मुबारकपुर	मूर्बनिक
murjha	मुर्झा	मूर्त्व
multae	मुल्ताई	मूलता
multai	मुल्ताई	मूल्ला
mushahid	मुशाहिद	मुश्युद्ध
muhavare	मुहावरे	मुहावर
muhavre	मुहावरे	मुहावर
mooth	मूठ	मूझ
muth	मूठ	मुद्त
mood	मूड	मूद
mud	मूड	म्डो
moodi	मूडी	मूदी
moody	मूडी	मूद
mool	मूल	मूल
mul	मूल	मूल
moolchand	मूलचंद	मूल्धन
mulchand	मूलचंद	मूल्धन
moolar	मूलर	मूलार
mular	मूलर	मूलार
muller	मूलर	मूल्लर
moolon	मूलों	मूलों
mulon	मूलों	मूलों
maxico	मेक्सिको	मैक्सिक
mexico	मेक्सिको	मेक्सियों
mega	मेगा	मेग
megapixal	मेगापिक्सल	मेगलार्ज
megapixel	मेगापिक्सल	मेग्निस्टर
mejbaan	मेजबान	मेजने
mejban	मेजबान	मेजने
mezbaan	मेजबान	मेजने
mejabani	मेजबानी	मेजाबानी
mejbaani	मेजबानी	मेजबानी
mejbani	मेजबानी	मेजबूना
mezabani	मेजबानी	मेजाबानी
mejbaan	मेज़बान	मेजने
mejban	मेज़बान	मेजने
mezbaan	मेज़बान	मेजने
mejbaani	मेज़बानी	मेजबानी
mejbani	मेज़बानी	मेजबूना
mezbaani	मेज़बानी	मेजबाइन
mate	मेट	मेट
met	मेट	मेट
mates	मेट्स	मत्सी
medical	मेडीकल	मेडिली
methanol	मेथेनॉल	मेथनुमा
menu	मेनू	मेनू
mem	मेम	मेम
melaghaat	मेलघाट	मेहमात्य
melghat	मेलघाट	मेम्हाल
melaanin	मेलानिन	मेलानिक
melanin	मेलानिन	मेलनिक
melaani	मेलानी	मेलानी
melani	मेलानी	मेलनी
maheman	मेहमान	महिमान
mehamaan	मेहमान	महामान
mehaman	मेहमान	महामान
mehmaan	मेहमान	मेहमान
mehman	मेहमान	मेहमान
meharaam	मेहराम	महारम
mehram	मेहराम	मेहरम
macbook	मैकबुक	मैक्निंग
matix	मैट्रिक्स	मतिकल
matrix	मैट्रिक्स	मत्त्रिक
mad	मैड	मैडी
made	मैड	माद
maid	मैड	मैड
maddy	मैडी	मददोद
maidi	मैडी	मैडि
main	मैन	मैन
man	मैन	मान
men	मैन	मेन
mainan	मैनन	मैनान
menon	मैनन	मेनों
manner	मैनर	मैनेर्स
maina	मैना	मैना
maine	मैने	मैन
marrej	मैरेज	मर्से
marriage	मैरेज	मर्येगी
merraige	मैरेज	मिराइनर
maisachusets	मैसाचुसेट्स	मैशलित्स
massachusetts	मैसाचुसेट्स	मस्त्लितिमांत
maisor	मैसोर	मैस्सर
maisore	मैसोर	मैस्क्री
mysore	मैसोर	मृज
mod	मॉड	मोड
mode	मॉड	मोड़े
modern	मॉडर्न	मोड़पुर
module	मॉड्यूल	मोडिल
modules	मॉड्यूल्स	मोडिस
modyuls	मॉड्यूल्स	मोडिस्स
mauritious	मॉरिशस	मौरुतिली
mauritius	मॉरिशस	मौरुतिल
mogali	मोगली	मोगली
mowgli	मोगली	मोवमीर
motive	मोटिव	मोडील
mol	मोल	मोल
mold	मोल्ड	मोड़ल
moshe	मोशे	मोशी
mosad	मोसाद	मोशा
mohana	मोहाना	मोहना
mohani	मोहानी	मोहनी
mohini	मोहिनी	मोहिनी
mohim	मोहिम	मोहिम
maukon	मौकों	मौकों
mauma	मौमा	मौमा
maurya	मौर्या	मौरा
morya	मौर्या	मोराय
maurya	मौर्यों	मौरा
mauryon	मौर्यों	मौरों
moryon	मौर्यों	मोरों
maulaviyon	मौलवियों	मौलवायों
maulvidon	मौलवियों	मौलहवों
maulviyon	मौलवियों	मौलवायों
maule	मौले	मौले
mauley	मौले	मौले
mausa	मौसा	मौसा
yatn	यत्न	यत
yatna	यत्न	यतान
yada	यदा	याद
yda	यदा	याद
yaduvansh	यदुवंश	यद्युम्धार
yaduwansh	यदुवंश	यदुर्मदाव
jerusalem	यरूशलेम	जृतलाली
yarooshaleim	यरूशलेम	यरोस्वरीमी
yarushalem	यरूशलेम	यरुल्यभाल
yashpaal	यशपाल	यश्रम
yashpal	यशपाल	यश्रम
yaatna	यातना	यातान
yatna	यातना	यतान
yaatanaon	यातनाओं	याताओं
yatnaon	यातनाओं	यताओं
yarayan	यात्राएं	यार्यन
yatraein	यात्राएं	यतरानी
yatraen	यात्राएं	यतरानी
yaariyan	यारियां	यारियां
yariyan	यारियां	यारियां
yaari	यारी	यारी
yari	यारी	यरी
yugam	युग्म	युगाम
yugm	युग्म	योमो
yuddhrat	युद्धरत	युद्धार्थ
yudhrat	युद्धरत	युद्धार्थ
ukrainian	यूक्रेनियन	उकराइनी
ukranian	यूक्रेनियन	उकरणकर
jerusalem	येरुशलम	जृतलाली
yorker	यॉर्कर	योरके
yojanaein	योजनाएं	योजनेबा
yojanaen	योजनाएं	योजनाएं
yojanaye	योजनाएं	योजाने
rangate	रंगते	रंगते
rangte	रंगते	रंगती
rangkata	रंजकता	रंगताओं
ranjkatha	रंजकता	रंझात्मक
ranjkta	रंजकता	रंजनें
raees	रईस	रायस
rais	रईस	रासी
raktaabh	रक्ताभ	रक्तहा
raktabh	रक्ताभ	रक्तह
rakhna	रखना	रखना
raghupati	रघुपति	रामपुरी
raghuram	रघुराम	रोमचरी
registerd	रजिस्टर्ड	रिंगठित्र
registered	रजिस्टर्ड	रिंगठित्री
ratanpur	रतनपुर	रापकर्म
runners	रनर्स	रुपर्जी
rayan	रयान	रायन
ryan	रयान	रिका
ralhan	रल्हन	रहता
ravish	रविश	रवीश
ravael	रवैल	रवली
ravel	रवैल	रवील
rawail	रवैल	रवली
rasad	रसद	रासद
rasaayanik	रसायनिक	रायसिना
rasaayanika	रसायनिक	रायसानिका
rasayanika	रसायनिक	रायसंयाक
rasyanik	रसायनिक	रसियां
rasaayanon	रसायनों	रायसानों
rasayanon	रसायनों	रायसानों
rahamat	रहमत	रहमास
rahmat	रहमत	रहमत
rhamat	रहमत	रामताह
rahenge	रहेंगे	रहनी
rahegi	रहेगी	रहिगी
rounder	राउंडर	राइंडर
raak	राक	राका
rak	राक	रक
raakhe	राखे	रखे
rakhe	राखे	रखे
raagon	रागों	रागों
ragon	रागों	रामों
raghavan	राघवन	रघवाज
raaj	राज	राज
raj	राज	राज
rajkot	राजकोट	राजकोत
rajtantra	राजतंत्र	रक्तरपत्ताओं
raajneetikaran	राजनीतीकरण	राजपातिकरण
rajneetikaran	राजनीतीकरण	राजनेत्रिक
rajnitikaran	राजनीतीकरण	राजपूर्ति
rajma	राजमां	रामता
rajman	राजमां	रामता
raajasva	राजस्व	राज्यावस
rajasva	राजस्व	राज्यावस
raaji	राजी	राजी
raji	राजी	राजी
rajinaama	राजीनामा	राजमिया
rajinama	राजीनामा	राजमिया
raajon	राजों	राजों
rajon	राजों	राजों
rana	राणा	रणा
raatrichar	रात्रिचर	राक्स्वरी
ratrichar	रात्रिचर	रात्रीह
raadhe	राधे	रखे
radhe	राधे	रखे
ranapur	रानापुर	रणनरी
rabin	राबिन	रबिन
robin	राबिन	रोबिन
rabha	राभा	रहन
ramkot	रामकोट	रामतों
ramkote	रामकोट	रामतिक
ramtek	रामटेक	रमातिक
rampur	रामपुर	रमरूप
rambharose	रामभरोसे	रमेमचर
rambharosey	रामभरोसे	रमेमार्भू
ramraj	रामराज	रमार्स
raalod	रालोद	रालोड़
ralaud	रालोद	रहमु
ralod	रालोद	रावोत
ravaley	रावले	रवली
ravle	रावले	रवील
rasayanik	रासायनिक	रायसंगीन
racreation	रिक्रिएशन	राक्सिकारिक
recreation	रिक्रिएशन	रिक्सिक्रियन
rig	रिग	रोगी
riggs	रिग्स	रिम्यू
rigs	रिग्स	रोमी
richual	रिचुअल	रुचियल
ritual	रिचुअल	रुल्स
reduction	रिडक्शन	रिक्षिकों
ripan	रिपन	रापाने
ripon	रिपन	रापों
ria	रिया	रिक
riya	रिया	रुया
rishte	रिश्ते	रुझ़ते
rishtey	रिश्ते	रुस्थी
risane	रिसने	रुलना
risaney	रिसने	रुलाना
risne	रिसने	रिमें
rihana	रिहाना	रहाना
rihanna	रिहाना	रहना
regal	रीगल	रिगल
rigal	रीगल	रुगल
reasonal	रीजनल	रिकस्मी
regional	रीजनल	रिगिलान
retreate	रीट्वीट	रेक्टर्स
retweet	रीट्वीट	रेट्रिक्स
reeta	रीता	रिता
rita	रीता	रोता
rukate	रुकते	रुक्ते
rukte	रुकते	रुक्ते
ruktey	रुकते	रुक्ते
rugan	रुग्ण	रुगन
rugna	रुग्ण	रुगन
ruganta	रुग्णता	रुमाना
rugnata	रुग्णता	रुमाना
rojvelt	रुजवेल्ट	रोजोर्थियम
roojwelt	रुजवेल्ट	रुस्थित्र
roosevelt	रुजवेल्ट	रुस्थिर्स
rodolph	रुडोल्फ	रोडिंग्र
rudolf	रुडोल्फ	रुद्सिस
rudolph	रुडोल्फ	रुद्रमह
roopesh	रुपेश	रुपर्श
rupesh	रुपेश	रुपर्स
ruby	रुबी	रूबी
roomani	रुमानी	रुमानी
rumani	रुमानी	रुमानी
rukavaton	रूकावटों	रुक्सादारों
root	रूट	रूत
route	रूट	रुल
rooting	रूटिंग	रुक्सिन
routine	रूटिंग	रिक्सने
routing	रूटिंग	रिसून
roots	रूट्स	रूसत
routes	रूट्स	रुल्ट
roopak	रूपक	रुपान
rupak	रूपक	रूपान
roopi	रूपी	रुपी
rupi	रूपी	रुपी
rantle	रेंटल	रेंटल
rental	रेंटल	रिंतल
registan	रेगिस्तान	रिंगकस्कीम
registani	रेगिस्तानी	रिंगिस्तान
reja	रेजा	रेजा
reza	रेजा	रेजा
rate	रेट	रते
rate	रेत	रते
ret	रेत	रेट
refaeli	रेफेली	रिलाली
refeli	रेफेली	रिल्स
reshe	रेशे	रेशे
reshey	रेशे	रिश्च
race	रेस	राई
rese	रेस	रेस
racer	रेसर	रारी
recer	रेसर	रिकर
racing	रेसिंग	रैक्सिंग
reson	रेसों	रिमों
rehaana	रेहाना	रहाना
rehana	रेहाना	रहना
racketeer	रैकेटियर	रक्तेरे
racketier	रैकेटियर	रैकेसर्क
rectare	रैकेटियर	रेक्टर
radical	रैडिकल	रक्तिहा
raidical	रैडिकल	रैडिलिया
raith	रैथ	राठ
rapping	रैपिंग	रंपिक
wrapping	रैपिंग	व्रूपों
robertsan	रॉबर्टसन	रोप्टर्सन
robertson	रॉबर्टसन	रोप्रिक्स
robinson	रॉबिंसन	रोबिंगों
royals	रॉयल्स	रोयल्स
rojlin	रोजलिन	रोजिल
rozlyn	रोजलिन	रोजित
rotation	रोटेशन	रोल्टकों
rodrigo	रोड्रिगो	रोडिंग
ronaldo	रोनाल्डो	रोनालों
ronit	रोनित	रोनित
roni	रोनी	रोनी
ropane	रोपने	रोपाने
ropaney	रोपने	रोपाने
ropne	रोपने	रोपने
robin	रोबिन	रोबिन
roya	रोया	रोया
rollers	रोलर्स	रॉलर्स
rovan	रोवन	रोवन
rowan	रोवन	रोड़ना
rosario	रोसारियो	रोलरो
rosariyo	रोसारियो	रोलरो
raubadaar	रौबदार	रचनेरा
raubadar	रौबदार	रचरणा
raubdar	रौबदार	रचरणा
landara	लंगड़ा	लंद्र
langada	लंगड़ा	लंगदा
langda	लंगड़ा	लंदगा
langar	लंगर	लागपार
langaron	लंगरों	लंगारों
langron	लंगरों	लंग्रियों
lambi	लंबी	लमी
lakeer	लकीर	लक्रे
lakir	लकीर	लक्करी
lakiron	लकीरों	लक्किरों
lakme	लक्मे	लक्मे
lakshmidhar	लक्ष्मीधर	लक्ष्मीदार
lakshmighar	लक्ष्मीधर	लक्ष्मीदारी
lakshy	लक्ष्य	लक्षा
lakshya	लक्ष्य	लक्षा
lakshyon	लक्ष्यों	लक्षों
lux	लक्स	लुटी
laksar	लक्सर	लक्सर
luxor	लक्सर	लुटीर
lakhkhi	लख्खी	लख्चे
lagna	लगना	लगना
laganewale	लगनेवाले	लगावती
lagnevaaley	लगनेवाले	लगावसीय
lagnewale	लगनेवाले	लगावती
lagega	लगेगा	लगाएं
lajjalu	लज्जालु	लजासील
latkate	लटकाते	लटकते
ladki	लड़की	लड़की
ladate	लड़ते	लड़कते
ladte	लड़ते	लड़ते
ladaai	लड़ाई	लड़ाई
ladai	लड़ाई	लड़ी
ladaaiyon	लड़ाईयों	लड़ायाओं
ladaeyon	लड़ाईयों	लादायिक
ladaiyon	लड़ाईयों	लड़कायी
lapetane	लपेटने	लाप्तपेन
lapetne	लपेटने	लेपटेंस
labada	लबादा	लाभना
lbada	लबादा	लेंदा
labdh	लब्ध	लब्दह
lbdh	लब्ध	लबड़
lalak	ललक	लालक
lalkarata	ललकारता	लाक्सराजार
lalkarta	ललकारता	लाक्सराजी
lalla	लल्ला	ललाती
lavasa	लवासा	लावसा
lovasa	लवासा	लोलावा
lassi	लस्सी	लस्सी
lahanaa	लहना	लहना
lahna	लहना	लहना
lehna	लहना	लहना
lahraee	लहराई	लहरारी
lahrai	लहराई	लहरीय
lehrayi	लहराई	लहरीय
lahalhati	लहलहाती	लहादितीय
lahlahaati	लहलहाती	लहादितला
lahlahati	लहलहाती	लहादितल
lahsun	लहसुन	लहजों
lasoon	लहसुन	लासून
lanchar	लांचर	लंभर
launcher	लांचर	लौखब्र
lycopene	लाइकोपिन	लुकरों
lime	लाइम	लाइमे
lives	लाइव्स	लिवर्स
live	लाईव	लिव
laegi	लाएगी	लायिन
lagataar	लागातार	लगातर
lagatar	लागातार	लगातर
laata	लाता	लाता
lata	लाता	लाता
laati	लाती	लाती
lati	लाती	लेटी
layega	लायेगा	लायने
lalpur	लालपुर	लापरिस
las	लास्ट	लास
last	लास्ट	लस्त
lindbhed	लिंगभेद	लिंदभीड
lingbhed	लिंगभेद	लिंगदेह
lindan	लिंडन	लिंदान
lindn	लिंडन	लिंदा
lindon	लिंडन	लिंदों
likhakar	लिखकर	लिखाकार
likhkar	लिखकर	लिखाकार
ligar	लिगर	लिगर
liger	लिगर	लिगर
liberation	लिबरेशन	लिपर्सिकार
libration	लिबरेशन	लाइपर्सन
liberation	लिब्रेशन	लिपर्सिकार
libration	लिब्रेशन	लाइपर्सन
leaderon	लीडरों	लेडिरों
leedaron	लीडरों	लीड़ियां
lidaron	लीडरों	लिडरों
liidaron	लीडरों	लिडियार्क
louis	लुईस	लूली
luis	लुईस	लिस
ludhakate	लुढ़कते	लुढ़कते
ludhkate	लुढ़कते	लुढ़कते
lurhakate	लुढ़कते	लुरहत्क
lutf	लुत्फ	लुटा
lumding	लुमडिंग	लुमदों
lootmaar	लूटमार	लूटमा
lootmar	लूटमार	लूटमार
landal	लेंडल	लंदल
lendal	लेंडल	लेंदल
lega	लेगा	लेगा
legaa	लेगा	लेगा
letakar	लेटकर	लेतकार
letkar	लेटकर	लेतकर
lenevali	लेनेवाली	लेंचलीय
lenewali	लेनेवाली	लेंचलीय
label	लेबल	लबले
labeling	लेबलिंग	लाबितियों
labelling	लेबलिंग	लाबितिलें
labelo	लेबलों	लबली
labelon	लेबलों	लबलिक
lebalon	लेबलों	लेलना
lemon	लेमन	लेमों
laingadan	लैंगडन	लैंगड़ों
langdon	लैंगडन	लंडों
lengdan	लैंगडन	लेंगड़न
laigikata	लैंगिकता	लैगिकला
laingikta	लैंगिकता	लैंगिताओं
lanset	लैंसेट	लंसते
lenset	लैंसेट	लेंजेस
lairi	लैरी	लैरी
lairy	लैरी	लैरिय
larry	लैरी	लर्से
lace	लैस	लाके
less	लैस	ल्यस्स
locket	लॉकेट	लोकते
laundry	लॉन्ड्री	लौंदरों
longewal	लोंगोवाल	लोगवाली
longewala	लोंगोवाल	लोगवाला
longoval	लोंगोवाल	लोगवाली
log	लोग	लोग
loge	लोगे	लोगे
lochdar	लोचदार	लोच्छा
lodi	लोदी	लोडिय
laurence	लौरेंस	लौरें
laurens	लौरेंस	लौजरी
laurense	लौरेंस	लौजेरी
wonder	वंडर	वोंडर
vansh	वंश	वंश
vanshdhar	वंशधर	वंश्व
vanshavad	वंशवाद	वंश्वा
vanshvaad	वंशवाद	वंश्व
vanshvad	वंशवाद	वंश्व
wanshwad	वंशवाद	वंश्व
vajood	वजूद	वासून
vajud	वजूद	वासूद
wajood	वजूद	वासून
vadali	वडाली	वादली
vadli	वडाली	वादली
wadali	वडाली	वादली
vanita	वनिता	वानित
vareinye	वरेण्य	वर्यीन
varenya	वरेण्य	वर्गाएं
varn	वर्ण	वर्न
varna	वर्ण	वर्ण
varnit	वर्णित	वर्जिन
vartamaan	वर्तमान	वर्तन्मा
vartaman	वर्तमान	वर्तन्म
vartmaan	वर्तमान	वर्जनाम
vartman	वर्तमान	वर्जन
varddhaman	वर्द्धमान	वर्तांड
vardhmaan	वर्द्धमान	वर्तावंद
vardhman	वर्द्धमान	वर्षन
verbal	वर्बल	वीरमी
varshan	वर्शन	वर्षन
vasharan	वर्शन	वाश्रापार
vershan	वर्शन	वर्वम
version	वर्शन	वीर्सियों
varsaache	वर्साचे	वर्षिया
varsaryache	वर्साचे	वर्सियार
vasearche	वर्साचे	वाशकरी
valkan	वल्कन	वालकन
valkkan	वल्कन	वाक्तिका
velkan	वल्कन	वेलकन
vash	वश	वासी
vashikaran	वशीकरण	वाश्यकारी
vaangchuk	वांगचुक	वांगिक
vangchuk	वांगचुक	वागिकाध
wangchuk	वांगचुक	वागिकाड़ी
want	वांट	वांट
vije	वाइज	विजे
vise	वाइज	विसे
wise	वाइज	विसे
vatar	वाटर	वात्र
water	वाटर	वात्र
watson	वाटसन	वत्सों
wattson	वाटसन	वट्टों
vaan	वाण	वान
waan	वाण	वान
vaanon	वाणों	वानों
vanon	वाणों	वानों
wanon	वाणों	वानों
vatanukulan	वातानुकूलन	वालनेंट
watanukoollan	वातानुकूलन	वालनित्मिक
vaadak	वादक	वादक
vadak	वादक	वादक
vaadiyon	वादियों	वादियों
vadiyon	वादियों	वादियों
wadiyon	वादियों	वादियों
vayana	वायना	वायन
vayna	वायना	वायन
wayna	वायना	वायन
wireless	वायरलेस	विरिस्सी
wirerless	वायरलेस	विरिस्ली
warrior	वारियर्स	वर्सी
warriors	वारियर्स	वर्सी
valve	वाल्व	वालीच
wolv	वाल्व	वोल्ड
vastavik	वास्तविक	वस्तियार
vastvik	वास्तविक	वस्तिक
vaahikayen	वाहिकाएं	वाहिकाएं
vahikayen	वाहिकाएं	वहीकायों
wahikayan	वाहिकाएं	वहीकायण
winter	विंटर	विंतर
vincent	विंसेंट	विंकते
vikalpon	विकल्पों	विकापित
wicket	विकेट	विकेत
vikramjeet	विक्रमजीत	विक्रमित्तर
vikramjit	विक्रमजीत	विक्रमित्त
vichaarakon	विचारकों	विचारकों
vicharakon	विचारकों	विचारकों
vigyan	विज्ञान	विग्ना
vigyaani	विज्ञानी	विग्नयागी
vigyani	विज्ञानी	विग्निया
vigyaanon	विज्ञानों	विग्नाणियों
vigyanon	विज्ञानों	विग्नाणियों
vitthal	विट्ठल	वित्तेश
viththal	विठ्ठल	विदेलहत
vitthal	विठ्ठल	वित्तेश
vitark	वितर्क	वित्रक
vidhaaein	विद्याएं	विधानी
vidyaayein	विद्याएं	विद्यायिक
vidyaen	विद्याएं	विद्यानी
vidhaaon	विद्याओं	विधायों
vidyaaon	विद्याओं	विद्याओं
vidyaon	विद्याओं	विद्याओं
vidhansabhaein	विधानसभाएं	विधानिकताएं
vidhansabhaen	विधानसभाएं	विधानिकताएं
vidhivat	विधिवत	विधिकाल
vidhut	विधुत	विधूत
vinasht	विनष्ट	विनाश्मा
vineet	विनीत	विनेस
vinit	विनीत	विंगती
vipreetataa	विपरीतता	विपर्तात्री
vipritata	विपरीतता	विपर्ताकार
vipra	विप्रा	विपर्र
vipro	विप्रो	विपोर
wipro	विप्रो	विपोर
vibha	विभा	विभा
vibhajak	विभाजक	विभाजन
vibhram	विभ्रम	विभर्म
vibhrm	विभ्रम	विभूर
vibram	विभ्रम	विपर्स
vimarsh	विमर्श	विम्मर
vimarsho	विमर्शों	विम्मर्व
vimarshon	विमर्शों	विम्मिपूर्ण
virajati	विराजती	विराजित
virechan	विरेचन	विरेखा
virodh	विरोध	विरोध
virodhabhasi	विरोधाभासी	विरुभवास
virodhabhason	विरोधाभासों	विरूवन्यता
vividh	विविध	विविद
vivekahin	विवेकहीन	विवेदनी
vivekheen	विवेकहीन	विवेकीन
visheshan	विशेषण	विशेषण
visheshanon	विशेषणों	विशेषणों
visheshaadhikaar	विशेषाधिकार	विश्वेक्षण
visheshadhikar	विशेषाधिकार	विश्वेक्षक
vishwasaniy	विश्वसनीय	विश्वासियां
vishwasniiya	विश्वसनीय	विश्वासियां
vishwasaniyata	विश्वसनीयता	विश्वस्पतियां
vishwasniiyataa	विश्वसनीयता	विश्वस्तिपूर्ण
vishahin	विषहीन	विशेषण
vishhin	विषहीन	विशेषण
vishanu	विष्णु	विषांग
vishnu	विष्णु	विषांग
vlc	वीएलसी	व्यूट
weeks	वीक्स	वीक्स
veerchand	वीरचंद	विरेदन
virchand	वीरचंद	विर्धन
veeresh	वीरेश	वीर्श
viresh	वीरेश	विरिष
vritton	वृत्तों	वृत्ति
vruton	वृत्तों	वृत्यों
vrutton	वृत्तों	वृत्ति
venkataraman	वेंकटरमन	वेनकास्त्र
venkatraman	वेंकटरमन	वेनकास्त्र
ved	वेड	वेड
wade	वेड	वाद
wed	वेड	वेड
wedding	वेडिंग	वेदिक
vediyon	वेदियों	वीडियों
vedon	वेदों	वेदों
venezuela	वेनेजुएला	वेनस्कली
veronica	वेरोनिका	वर्रों
veronika	वेरोनिका	वर्रों
weronika	वेरोनिका	वर्रों
velvet	वेलवेट	वेवित्स
welwet	वेलवेट	वेवित्स
welder	वेल्डर	वेवर्स
weldor	वेल्डर	वेवर्स
welding	वेल्डिंग	वेलिंग
wealth	वेल्थ	वेडल
vellur	वेल्लूर	वेलर्स
velur	वेल्लूर	वेलर
vesh	वेश	वेश
wasting	वेस्टिंग	वस्सिन
westing	वेस्टिंग	वेस्तिन
wastinghouse	वेस्टिंगहाउस	वस्सिमिच
westinghouse	वेस्टिंगहाउस	व्यूजिशित
vaisley	वेस्ले	वासिली
vesle	वेस्ले	वेसेस
wesle	वेस्ले	वेसेस
vaigyaanik	वैज्ञानिक	वैजियां
vaigyanik	वैज्ञानिक	वैजियां
vegyanik	वैज्ञानिक	वेगिकाओं
vaigyaanikta	वैज्ञानिकता	वैजियां
vaigyanikata	वैज्ञानिकता	वैजियां
vaigyanikta	वैज्ञानिकता	वैजियां
vaitravati	वैत्रवती	वैक्सर्वता
vaitrawati	वैत्रवती	वैक्सर्वता
vaimanasy	वैमनस्य	वैमायास
vaimanasya	वैमनस्य	वैमायासा
vaimanya	वैमनस्य	वैमायन
very	वैरी	वीर्स
vaisaakh	वैशाख	वैस्का
vaishakh	वैशाख	वैषद
vaishaakhi	वैशाखी	वैश्वाइक
vaishakhi	वैशाखी	वैशिका
vaishnodevi	वैष्णोदेवी	वैश्विनी
vyaktigat	व्यक्तिगत	व्याकामित
vyagr	व्यग्र	व्याप
vyagra	व्यग्र	व्यागर
vyatit	व्यतीत	व्यस्ति
vytit	व्यतीत	व्यूत्त
vyabhichar	व्यभिचार	व्याभारी
vyabhichari	व्यभिचार	व्याग्रहीद
vyavadhan	व्यवधान	व्यायाधान
vyavdhan	व्यवधान	व्यायभा
vyavahargat	व्यवहारगत	व्यायापार्थव
vyvhargat	व्यवहारगत	व्यवहासपूर्ण
vyaghat	व्याघात	व्यागत
vyapak	व्यापक	व्यापन
vlad	व्लाद	व्हात
wlaad	व्लाद	व्हात
vladimir	व्लादिमीर	व्विस्ट्री
shanghai	शंघाई	शागीभ
shatpath	शतपथ	क्षताप
shanivar	शनिवार	शानीवार
shaniwar	शनिवार	शानीवार
shabana	शबाना	शबाना
shbana	शबाना	शबाना
shabdarth	शब्दार्थ	शब्तारह
shamadan	शमादान	शमदान
shmadan	शमादान	श्यंदत
shamitabh	शमिताभ	शमीदाल
shamil	शमिल	शमील
shmil	शमिल	श्लीम
sharabon	शराबों	शरणौर
shrabon	शराबों	श्रापूर्ण
shararat	शरारत	शराते
shrart	शरारत	श्राते
sharmana	शर्माना	शर्मांगा
shaharwasiyon	शहरवासियों	शाहरवासियों
shahrvasiyon	शहरवासियों	शाहरावसीदों
shervasiyon	शहरवासियों	शर्विताओं
shahdara	शहादरा	शाहारा
shaantikaal	शांतिकाल	शांतिकाल
shantikal	शांतिकाल	शांतिकाल
shaao	शाओ	शाओ
shao	शाओ	शो
shaakir	शाकिर	शाकीर
shakir	शाकिर	क्षारी
shaakhaaen	शाखाएं	शाखाने
shakhayan	शाखाएं	शाकायाद
shakhayen	शाखाएं	शाक्याएं
shayak	शायक	शायक
shaavakon	शावकों	शावकों
shavakon	शावकों	शावकों
shavkon	शावकों	शावों
shaasaka	शासक	शासका
shasak	शासक	शासक
sasakon	शासकों	सस्काकों
shaasakon	शासकों	शास्काओं
shasakon	शासकों	शास्कों
shipra	शिप्रा	शिप्र
shirke	शिर्के	शिरके
sheershakon	शीर्षकों	शिर्वक्ति
shirshakon	शीर्षकों	शिर्दितों
shirshkon	शीर्षकों	शिर्दितों
shujaat	शुजात	शुटाज
shujat	शुजात	शूटत
shooting	शुटिंग	शूटियों
shutting	शुटिंग	शुट्क्सिन
should	शुड	शूल्ड
shud	शुड	शूद
shubhankar	शुभंकर	शूभकारा
shumaali	शुमाली	शूमलाई
shumali	शुमाली	शूमली
shringaar	शृंगार	श्रीनिया
shringar	शृंगार	श्रीनी
shrungar	शृंगार	श्रृंग
sheling	शेलिंग	शेलिंग
shelling	शेलिंग	शेलिसिंग
shaili	शैली	शाली
shaly	शैली	शालू
sheli	शैली	शेली
shaishav	शैशव	शैयदेश
sean	शॉन	सीन
shaun	शॉन	शौन
shawn	शॉन	शावन
short	शोर्ट	शोर्ट
sure	श्योर	सुरे
shrankhala	श्रंखला	श्रांभारा
shrankhalaa	श्रंखला	श्रांदला
shrunkhla	श्रंखला	श्रृंखल
shrankhalaaon	श्रंखलाओं	श्रांशकार
shrinkhalaon	श्रंखलाओं	श्रीमारोंदुर
shrunkhlaon	श्रंखलाओं	श्रृंखलों
shravani	श्रावणी	श्रवानी
shrikar	श्रीकर	श्रीकार
shrikhand	श्रीखंड	श्रीकाधों
shrimati	श्रीमति	श्रीमित
shriram	श्रीराम	श्रीमार
sriram	श्रीराम	सृजाई
shrotaon	श्रोताओं	श्रोतों
shat	षट्	शत
sankhyaein	संख्याएं	संक्षेया
sankhyaen	संख्याएं	संक्षेया
sankhyayen	संख्याएं	संक्षेयन
sanghanit	संघनित	संग्रहत्न
sanghnit	संघनित	संघित
sanchayan	संचयन	संचायान
sanchar	संचार	संचर
sanchaari	संचारी	संचरी
sanchari	संचारी	संचरी
sanchalanon	संचालनों	संचालयों
sanchalnon	संचालनों	संचिक्सन
sanjay	संजय	संगत्य
sanjeevan	संजीवन	संज्ञानिच
sanjivan	संजीवन	संज्ञापिहों
santati	संतति	संताती
sandarbh	संदर्भ	संद्रह
sandarbha	संदर्भ	संद्रहार
sandrbh	संदर्भ	संधर
sandarbhon	संदर्भों	संद्रहणी
sandrbhon	संदर्भों	संदूरदंड
sandali	संदली	संदीला
sandli	संदली	संदील
sandhan	संधान	संदाहन
samprati	संप्रति	संपूर्ण
samprti	संप्रति	संपूर्त
samprabhu	संप्रभु	संपर्चीय
samprbhu	संप्रभु	संपूर्ण
samprabhuta	संप्रभुता	संपर्चर्जी
samprbhuta	संप्रभुता	संपर्चित
sambit	संबित	समीते
sambhalane	संभालने	संभालिका
sambhalne	संभालने	संभालिक
sambhrant	संभ्रांत	संभार्ती
sanbharnt	संभ्रांत	संहर्तापूर्ण
sanyog	संयुक्त	संयोग
sanyukt	संयुक्त	संगूतक
sanyukta	संयुक्त	संगूकता
sanyukta	संयुक्ता	संगूकता
sanyogvash	संयोगवश	संग्रहवास
sanyojan	संयोजन	संयोतन
sanyojanon	संयोजनों	संयोजनों
sanyojnon	संयोजनों	संयोजनों
samvedikaran	संवेदीकरण	संविधाएं
sanvedikaran	संवेदीकरण	संवेदकारी
samshayon	संशयों	समास्कों
sanshayon	संशयों	संस्वाण
sanshyon	संशयों	संस्ञानि
sanskaar	संस्कार	संस्कार
sanskar	संस्कार	संस्कार
sanskaari	संस्कारी	संस्कारिक
sanskari	संस्कारी	संस्कारिक
sanskrit	संस्कृत	संस्तूपूर्ण
sanskurt	संस्कृत	संस्तूपूर्ण
sanskritiyan	संस्कृतियां	संस्तूपिरों
sanskrutiyan	संस्कृतियां	संस्तूपिरों
sanskritiyon	संस्कृतियों	संस्कृतियों
sanskrutiyon	संस्कृतियों	संस्कृतियों
sanasthit	संस्थित	संहमतम
sansthit	संस्थित	संस्थित
sanasthita	संस्थिता	संघटताम
sansthita	संस्थिता	संस्थानित
sakara	सकरा	सकारा
sakra	सकरा	सक्र
sakshan	सक्शन	सक्षण
suction	सक्शन	सुलकों
sacchidanand	सच्चिदानंद	सच्छादीन
sachhidanand	सच्चिदानंद	सच्चिदायक
sachidanand	सच्चिदानंद	सच्चायों
sajja	सज्जा	सजाज़
sat	सत	सत
satpal	सतपाल	सत्तापूर
satluj	सतलुज	सत्लूम
sataane	सताने	साताने
satane	सताने	साताने
sate	सते	साते
satti	सत्ती	सत्ती
satvat	सत्वत	सत्ताव
sadanand	सदानंद	सद्दानों
sapane	सपने	सपने
sapne	सपने	सपकी
sapney	सपने	सप्कार
saparivaar	सपरिवार	सप्वारी
sapariwar	सपरिवार	सप्वारी
sparivar	सपरिवार	स्पर्वीय
sapaat	सपाट	सपता
sapat	सपाट	सपता
sapate	सपाटे	सप्तार
sapatey	सपाटे	सप्तार
saptakranti	सप्तक्रांति	सप्तार्मक
saptkraanti	सप्तक्रांति	सप्तरपूर्त
saptapadi	सप्तपदी	सप्ताहाद
saptpadi	सप्तपदी	सप्ताहिन
saptari	सप्तरी	सप्तरी
sapramaan	सप्रमाण	सप्माकार
sapraman	सप्रमाण	सप्माकार
submit	सबमिट	सुब्मित
sabmission	सबमिशन	संस्तितियों
submission	सबमिशन	स्लोमिकली
sabhaein	सभाएं	सहनेगा
sabhaen	सभाएं	सभाके
sabhayen	सभाएं	सहनाएं
sabhen	सभाएं	सभें
sabhasadon	सभासदों	संभाओं
sabhyata	सभ्यता	सभायता
samjhoonga	समझूंगा	समुंदलों
samjhunga	समझूंगा	समझिक
samjhungaa	समझूंगा	समझाइं
saman	समन	समान
samanvayaka	समन्वयक	समाचाओं
samanwayaka	समन्वयक	समाचाओं
samnvyak	समन्वयक	संवाणों
samaadhaan	समाधान	समाधन
samadhan	समाधान	समाधन
samadhiyon	समाधियों	समाधियों
samadjiyon	समाधियों	समाजोदियों
samalakha	समालखा	समाचाल
samalakhaa	समालखा	समाचालन
samahaar	समाहार	समाहर
samahar	समाहार	समाहर
samitiyan	समितियां	संबालों
sametati	समेटती	समेत्मा
sametti	समेटती	समेतित
sarka	सरका	सरका
sarkaa	सरका	सरका
sarkarein	सरकारें	सरकाकीर
sarkaren	सरकारें	सरकाकी
sarkaaron	सरकारों	सरकाकी
sarkaron	सरकारों	सरकाकी
sargana	सरगना	सरगाना
sarganaon	सरगनाओं	सरगानों
sargi	सरगी	सरगी
sarguja	सरगुजा	सरगाल
sarjuga	सरगुजा	सर्जिया
sarsa	सरसा	सरसा
sarsaa	सरसा	सरसा
sarahind	सरहिंद	सर्धानी
sarhind	सरहिंद	सर्चांग
sirhind	सरहिंद	सिर्चों
saraaha	सराहा	सरहा
saraha	सराहा	सरहा
saraahi	सराही	सरहाई
sarahi	सराही	सरहाई
salaahkar	सलाहकार	सलाकार्ह
salahkaar	सलाहकार	सालखाकार
salahkar	सलाहकार	सालखाकार
saleeb	सलीब	सलीब
salib	सलीब	सलीब
select	सलेक्ट	सेल्टे
saltanat	सल्तनत	सलताता
saltnat	सल्तनत	सलतात
savaal	सवाल	सावल
saval	सवाल	सवाल
sawaal	सवाल	सावल
sawal	सवाल	सावल
sahakalaakar	सहकलाकार	सहकाक्षर
sahakalakar	सहकलाकार	सहकाक्षर
sahkalakar	सहकलाकार	सहकाक्षर
sahadev	सहदेव	सहकव
sahdev	सहदेव	सहकव
sahrawat	सहरावत	सहराहत
sherawat	सहरावत	शर्वता
sahooliyata	सहूलियत	सहोलियात्या
sahuliyat	सहूलियत	सहयोलिता
sahuuliyata	सहूलियत	सहोलियालय
saanketika	सांकेतिक	सांक्तिकार
sanketik	सांकेतिक	संकटिक
saimans	साइमंस	सैम्यास
simmons	साइमंस	सामोस्टि
symons	साइमंस	स्मोतों
saima	साइमा	सैमा
sagarika	सागरिका	सागरिका
sagrika	सागरिका	सग्रेयक
saga	सागा	सगा
saajan	साजन	साजन
sajan	साजन	सजान
saajsajja	साजसज्जा	सासतमा
sajsajja	साजसज्जा	सजसतास
saja	साजा	सजा
saathsaath	साथसाथ	साशताश
sathsath	साथसाथ	सत्साह्ष
sathiya	साथिया	सहकासी
saabah	साबाह	साभा
sabah	साबाह	सहन
samanjasy	सामंजस्य	समास्यता
samanjasya	सामंजस्य	समास्यता
samoa	सामोआ	समू
samoaa	सामोआ	समू
saayn	सायं	सायन
sayan	सायं	सायन
saym	सायं	साम
saira	सायरा	सैरा
sayara	सायरा	सायार
sayra	सायरा	सायर
salve	साल्वे	सलीव
sahab	साहब	सहाब
singapore	सिंगापुर	सिंगारी
singaar	सिंगार	सिंगार
singar	सिंगार	सिंगार
singer	सिंगार	सिंगर
singhaadey	सिंघाड़े	सिंहदाह
singhade	सिंघाड़े	सिंहदी
singhde	सिंघाड़े	सिंहूद
singhre	सिंघाड़े	सिंहरी
singhi	सिंघी	सिंगी
singha	सिंहा	सिंघा
sinha	सिंहा	सिना
siera	सिएरा	सीरा
sierra	सिएरा	सीरिया
sikud	सिकुड़	सिक्षों
signals	सिगनल्स	सिग्नलम
cigaretton	सिगरेटों	किंगर्सन
cigretton	सिगरेटों	किंपिक्स
siddhivat	सिद्धवट	सिद्धाविज्ञ
siddhvat	सिद्धवट	सिद्धात्व
siddhwat	सिद्धवट	सिद्धात्व
sinabang	सिनाबंग	सिनाकाई
synapse	सिनेप्स	स्पर्जा
sipah	सिपाह	सिपाह
sipaha	सिपाह	सिपाहा
sipahiyon	सिपाहियों	सियापूर्वों
sipahi	सिपाही	सिपहिर्य
sim	सिम	सीम
simat	सिमट	सिमात
simatataa	सिमटता	सिमातता
simatta	सिमटता	सिमातता
simtata	सिमटता	सिमताता
simtataa	सिमटता	सिमताता
cement	सिमटे	सेमेट
simate	सिमटे	सिमाते
simi	सिमी	सिमी
simmy	सिमी	सिम्म
sims	सिम्स	सीम्म
siyasi	सियासी	सियाली
siyah	सियाह	सियाह
siyaha	सियाह	सियाहा
sirpur	सिरपुर	साइंरी
sivan	सिवान	सिवान
siwan	सिवान	सिवान
sisva	सिसवा	सिसवा
siswa	सिसवा	सिसवा
cil	सीआईएल	सील
csi	सीएसआई	स्ल
sikar	सीकर	सिकार
seaten	सीटें	सेतें
sitaram	सीताराम	सित्राम
sitaharan	सीताहरण	सितारणाएं
cpm	सीपीएम	एसपीएस
cps	सीपीएस	एसपीएस
cbse	सीबीएसई	सेब्स
seem	सीम	सीम
sim	सीम	सीम
sealed	सील्ड	सेडली
shield	सील्ड	शिली
ccd	सीसीडी	सीडी
sugamata	सुगमता	सुमानास
sugmta	सुगमता	सुम्मान
sujan	सुजेन	सुजान
sujen	सुजेन	सुजून
suken	सुजेन	सुक्की
sujain	सुजैन	सुजाइन
sujhaati	सुझाती	सुझासी
sujhati	सुझाती	सुझासी
sutali	सुतली	सुलझा
sutli	सुतली	सुलझी
suta	सुता	सुता
sdueep	सुदीप	स्क्रीन
sudip	सुदीप	सुदूप
sudhaargrah	सुधारगृह	सुधारहव
sudhargrih	सुधारगृह	सुधारी
sudhargruh	सुधारगृह	सुधारी
sunaaron	सुनारों	सुनारों
sunaron	सुनारों	सुनारों
sunaseer	सुनासीर	सुनारी
sunasir	सुनासीर	सुनार्मी
suneeti	सुनीति	सुनित्मी
suniti	सुनीति	सुनित्मी
sunega	सुनेगा	सुनाएं
suneyga	सुनेगा	सुन्या
superhit	सुपरहिट	सुपहित्री
supachy	सुपाच्य	सुनहारो
supachya	सुपाच्य	सुनावा
supachye	सुपाच्य	सुनहरों
subhaay	सुभाय	सुभाया
subhay	सुभाय	सुभा
surveen	सुरवीन	सुरवीं
survin	सुरवीन	सुरवों
surana	सुराणा	सुराना
sulkhan	सुलखान	सुलझान
suljaayi	सुलझाई	सुलझागी
suljayi	सुलझाई	सुलझागी
suljhai	सुलझाई	सुलझागी
sulzai	सुलझाई	सुलझाग
sultana	सुलताना	सुलझाना
sulaati	सुलाती	सुलझाओं
sulati	सुलाती	सुलझाओं
susanskrit	सुसंस्कृत	सुस्तापूर्ति
susanskrut	सुसंस्कृत	सुस्तापूर्ति
suhagin	सुहागिन	सुहागों
soond	सूंड़	सूंड
sund	सूंड़	सुंड
suiyan	सूइयां	सुयानु
sukhati	सूखती	सुखाती
sukhti	सूखती	सुखती
sukhakar	सूखाकर	सुकाचार
soochak	सूचक	सूचको
suchak	सूचक	सूचक
sooja	सूजा	सूझा
suja	सूजा	सुजा
suba	सूबा	सुबा
sube	सूबे	सूबे
sooraj	सूरज	सूर्यम
suraj	सूरज	सुराज
surinaam	सूरीनाम	सुर्बास
surinama	सूरीनाम	सूर्यनामी
suriname	सूरीनाम	सुरूपता
suryadev	सूर्यदेव	सुर्वाहा
sendha	सेंधा	सेंदाह
senvai	सेंवई	सेवनी
sevai	सेंवई	सेवाई
sensing	सेंसिंग	सेंसीन
sexual	सेक्सुअल	सेक्सिल
saturday	सेटरडे	सत्यार्थ
seti	सेटी	सेती
seto	सेटो	स्टो
seth	सेथ	सेठ
safety	सेफ्टी	सफेकाज
semen	सेमिन	सेमें
semin	सेमिन	सेमिक
self	सेल्फ	सेल
selfie	सेल्फी	सेलील
save	सेव	सवे
sev	सेव	स्वो
sevakon	सेवकों	सेवकों
sevkon	सेवकों	सेवकों
samuels	सैम्युल्स	समूली
celery	सैलरी	स्लेरी
salary	सैलरी	सलारी
sakar	सॉकर	सकार
socar	सॉकर	सोकर
soccer	सॉकर	सौकर
songs	सॉन्ग्स	सोनस
solicitor	सॉलिसिटर	सोलिसिक
sochane	सोचने	सोचने
sochne	सोचने	सोचें
sonu	सोनू	सोनी
soma	सोमा	सोमा
spma	सोमा	स्पम
somi	सोमी	सोमी
soy	सोय	सोय
soya	सोया	सोया
solitaire	सोलिटेयर	सोलिसेरे
soharai	सोहराई	सोहारीय
sohrai	सोहराई	सोहरीय
sohaval	सोहावल	सोहावसी
sohawal	सोहावल	सोहावसी
saunpane	सौंपने	सौनकर
sonpne	सौंपने	सोनकर
scala	स्काला	स्काला
skala	स्काला	स्काला
ski	स्की	स्की
scootaron	स्कूटरों	स्कूलों
scooteron	स्कूटरों	स्कूलिक
skootaron	स्कूटरों	स्कूल्का
scandinavia	स्कैंडिनेविया	स्कंभवादी
scaining	स्कैनिंग	स्कीनियों
scanning	स्कैनिंग	स्कंबों
squash	स्क्वाश	स्कोल्ड
squash	स्क्वैश	स्कोल्ड
skhalan	स्खलन	स्काभाती
stain	स्टैन	स्टैक
stan	स्टैन	स्टंट
stop	स्टॉप	स्टोप
stops	स्टॉप्स	स्टोप्स
stone	स्टोन	स्टंब
straws	स्ट्रास	स्त्रव्य
stress	स्ट्रास	स्ट्रिस
stra	स्ट्रे	स्टार
stray	स्ट्रे	स्ट्रा
stre	स्ट्रे	स्ट्री
strocks	स्ट्रोक्स	स्तूरोक्स
strokes	स्ट्रोक्स	स्तूरोट
stan	स्तन	स्टंट
stanadhari	स्तनधारी	स्टंभरीय
standhaari	स्तनधारी	स्टंभरी
standhari	स्तनधारी	स्टंभर
sthiti	स्तिथि	स्थिलिक
stithi	स्तिथि	स्टेडिल
stuti	स्तुति	स्टूल
sthitiyaan	स्थितियां	स्थिकासिक
sthitiyan	स्थितियां	स्थिकिसा
sthitiyon	स्थितियों	स्थिक्सियों
sthool	स्थूल	स्थूल
sthul	स्थूल	स्थूल
sthoolta	स्थूलता	स्थलूक्स
sthulata	स्थूलता	स्थलकाल
sneakers	स्नीकर्स	स्पेक्रेंस
snickers	स्नीकर्स	स्क्रिप्टिक
snikarse	स्नीकर्स	स्काइप्टर
spear	स्पीयर	स्प्रेय
spell	स्पेल	स्प्लिंग
spelar	स्पेलर	स्पेरल
speller	स्पेलर	स्प्लिप्स
sprint	स्प्रिट	स्प्रेक्ट
sprit	स्प्रिट	स्पर्जर
spray	स्प्रे	स्प्राइन
spry	स्प्रे	स्प्राइ
sfoorti	स्फूर्ति	स्तूरिस
sfurti	स्फूर्ति	स्तूरित
sphoorti	स्फूर्ति	स्पोर्डियर्स
slide	स्लाइड	स्लीड
slider	स्लाइडर	स्लीडर
slaaidon	स्लाइडों	स्लैडियों
slidon	स्लाइडों	स्लीडों
sliders	स्लाइड्स	स्लीफर
slides	स्लाइड्स	स्लीडी
slice	स्लाइस	स्ली
slash	स्लैश	स्लाश
swaroopon	स्वरुपों	स्वरों
swarupon	स्वरुपों	स्वरों
swa	स्वा	स्वा
swaachaalit	स्वाचालित	स्वालितिहा
swachalit	स्वाचालित	स्वच्छला
swaarthparak	स्वार्थपरक	स्वर्धनाक्षण
swarthparak	स्वार्थपरक	स्वर्धनात्न
swiftlate	स्विफ्टलेट	स्लीफल्ड
swiftlet	स्विफ्टलेट	स्लीडिक्स
sweekarte	स्वीकारते	स्वेक्टर्क
swikarte	स्वीकारते	स्वीकृत
sweet	स्वीट	स्लेड
sweep	स्वीप	स्वीप
sweccha	स्वेच्छा	स्वीचा
swecha	स्वेच्छा	स्वेच
swechha	स्वेच्छा	स्वेच्छ
sweta	स्वेता	स्लैड
swap	स्वैप	स्वप
swipe	स्वैप	स्वीप
handiya	हंडिया	हंदायी
handiyaa	हंडिया	हंदाया
hundiya	हंडिया	हुनावों
hakikat	हकीकत	हकितक
haqeeqat	हकीकत	हक्केती
hathiya	हथिया	हाथिया
hamala	हमला	हमाला
hamla	हमला	हमाल
hamalavar	हमलावर	हमावलर
hamlavar	हमलावर	हमावर्ती
humlavar	हमलावर	हमरवाल
hamaal	हमाल	हमाल
hamal	हमाल	हमाल
hercules	हरक्यूलिस	हेरिस्टे
hardas	हरदास	हर्दास
harpaal	हरपाल	हर्नल
harpal	हरपाल	हर्नल
harvansh	हरवंश	हर्वमा
haraval	हरावल	हरावल
harawal	हरावल	हरावल
hurricane	हरिकेन	हरुकीकर
harijan	हरिजन	हरिजान
hariyali	हरियाली	हरियाली
harshit	हर्षित	हर्शित
haldi	हल्दी	हल्डी
halla	हल्ला	हलाल
hawamahal	हवामहल	हावमावास
hawalaat	हवालात	हावलता
hawalat	हवालात	हावलत
hasino	हसीनों	हसीन
hasinon	हसीनों	हसीनों
haan	हां	हान
han	हां	हान
haanfte	हांफते	हांतते
hafate	हांफते	हाताते
hanfte	हांफते	हंतते
higman	हाइमन	हिग्मन
hymen	हाइमन	हमान
hadauti	हाड़ौती	हड़तीय
haani	हानी	हानी
hani	हानी	हैनी
haarjeet	हारजीत	हर्जेल
harjeet	हारजीत	हर्जेल
haaranaa	हारना	हायनर
harana	हारना	हराना
harna	हारना	हरना
haalchaal	हालचाल	हैवल
haalchal	हालचाल	हैवल
halchaal	हालचाल	हल्थि
halchal	हालचाल	हल्थि
halt	हाल्ट	हल्त
hault	हाल्ट	हौती
hahakar	हाहाकार	हाक्रह
hingis	हिंगिस	हिग्मी
hindan	हिंडन	हिंदान
hindon	हिंडन	हिंदों
hijada	हिजड़ा	हिझाया
hijda	हिजड़ा	हिजड़ा
hijbul	हिजबुल	हिजील
hippo	हिप्पो	हैनो
hippopotamus	हिप्पोपोटेमस	हैनोर्मोंस
himali	हिमाली	हिमली
hilane	हिलने	हिलने
hilne	हिलने	हिलने
hisham	हिशाम	हिशम
heeraganj	हीरागंज	हेरामान्य
hiraganj	हीरागंज	हिरामन
heroes	हीरोज	हर्जू
heros	हीरोज	हर्स
hui	हुईं	हुई
huin	हुईं	हुन
hooper	हूपर	हुब्र
huppar	हूपर	हबरान
hupper	हूपर	हबरे
hegde	हेगडे	हेगे
hemvati	हेमवती	हेम्मादी
hemwati	हेमवती	हेम्मेदार
help	हेल्प	हेलप
helper	हेल्पर	हेलेप्स
haito	हैतो	हैक्स
hairam	हैरम	हैरम
harem	हैरम	हर्ज
herald	हैराल्ड	हेरावत
haive	हैव	हैवी
have	हैव	हावे
hong	हॉन्ग	होग
half	हॉफ	हल्त
hoaf	हॉफ	होसा
hounga	होऊंगा	होगिया
holding	होल्डिंग	होलोंदु
hoshangabaad	होशंगाबाद	होशनदायु
hoshangabad	होशंगाबाद	होशनदायु
hostes	होस्टेस	होस्तेस
